Resumption of the session	Wiederaufnahme der Sitzungsperiode
I declare resumed the session of the European Parliament adjourned on Friday 17 December 1999, and I would like once again to wish you a happy new year in the hope that you enjoyed a pleasant festive period.	Ich erkläre die am Freitag, dem 17. Dezember unterbrochene Sitzungsperiode des Europäischen Parlaments für wiederaufgenommen, wünsche Ihnen nochmals alles Gute zum Jahreswechsel und hoffe, daß Sie schöne Ferien hatten.
Although, as you will have seen, the dreaded 'millennium bug' failed to materialise, still the people in a number of countries suffered a series of natural disasters that truly were dreadful.	Wie Sie feststellen konnten, ist der gefürchtete "Millenium-Bug " nicht eingetreten. Doch sind Bürger einiger unserer Mitgliedstaaten Opfer von schrecklichen Naturkatastrophen geworden.
You have requested a debate on this subject in the course of the next few days, during this part-session.	Im Parlament besteht der Wunsch nach einer Aussprache im Verlauf dieser Sitzungsperiode in den nächsten Tagen.
In the meantime, I should like to observe a minute' s silence, as a number of Members have requested, on behalf of all the victims concerned, particularly those of the terrible storms, in the various countries of the European Union.	Heute möchte ich Sie bitten - das ist auch der Wunsch einiger Kolleginnen und Kollegen -, allen Opfern der Stürme, insbesondere in den verschiedenen Ländern der Europäischen Union, in einer Schweigeminute zu gedenken.
Please rise, then, for this minute' s silence.	Ich bitte Sie, sich zu einer Schweigeminute zu erheben.
(The House rose and observed a minute' s silence)	(Das Parlament erhebt sich zu einer Schweigeminute.)
Madam President, on a point of order.	Frau Präsidentin, zur Geschäftsordnung.
You will be aware from the press and television that there have been a number of bomb explosions and killings in Sri Lanka.	Wie Sie sicher aus der Presse und dem Fernsehen wissen, gab es in Sri Lanka mehrere Bombenexplosionen mit zahlreichen Toten.
One of the people assassinated very recently in Sri Lanka was Mr Kumar Ponnambalam, who had visited the European Parliament just a few months ago.	Zu den Attentatsopfern, die es in jüngster Zeit in Sri Lanka zu beklagen gab, zählt auch Herr Kumar Ponnambalam, der dem Europäischen Parlament erst vor wenigen Monaten einen Besuch abgestattet hatte.
Would it be appropriate for you, Madam President, to write a letter to the Sri Lankan President expressing Parliament's regret at his and the other violent deaths in Sri Lanka and urging her to do everything she possibly can to seek a peaceful reconciliation to a very difficult situation?	Wäre es angemessen, wenn Sie, Frau Präsidentin, der Präsidentin von Sri Lanka in einem Schreiben das Bedauern des Parlaments zum gewaltsamen Tod von Herrn Ponnambalam und anderen Bürgern von Sri Lanka übermitteln und sie auffordern würden, alles in ihrem Kräften stehende zu tun, um nach einer friedlichen Lösung dieser sehr schwierigen Situation zu suchen?
Yes, Mr Evans, I feel an initiative of the type you have just suggested would be entirely appropriate.	Ja, Herr Evans, ich denke, daß eine derartige Initiative durchaus angebracht ist.
If the House agrees, I shall do as Mr Evans has suggested.	Wenn das Haus damit einverstanden ist, werde ich dem Vorschlag von Herrn Evans folgen.
Madam President, on a point of order.	Frau Präsidentin, zur Geschäftsordnung.
I would like your advice about Rule 143 concerning inadmissibility.	Könnten Sie mir eine Auskunft zu Artikel 143 im Zusammenhang mit der Unzulässigkeit geben?
My question relates to something that will come up on Thursday and which I will then raise again.	Meine Frage betrifft eine Angelegenheit, die am Donnerstag zur Sprache kommen wird und auf die ich dann erneut verweisen werde.
The Cunha report on multiannual guidance programmes comes before Parliament on Thursday and contains a proposal in paragraph 6 that a form of quota penalties should be introduced for countries which fail to meet their fleet reduction targets annually.	Das Parlament wird sich am Donnerstag mit dem Cunha-Bericht über mehrjährige Ausrichtungsprogramme befassen, der in Absatz 6 vorschlägt, daß Länder, die ihr Soll zur Flottenverkleinerung nicht erfüllen, jährlich mit einer Art Quotenstrafe belegt werden sollen.
It says that this should be done despite the principle of relative stability.	Und zwar sollen derartige Strafen trotz des Grundsatzes der relativen Stabilität verhängt werden.
I believe that the principle of relative stability is a fundamental legal principle of the common fisheries policy and a proposal to subvert it would be legally inadmissible.	Ich meine, daß der Grundsatz der relativen Stabilität einen elementaren Rechtsgrundsatz der gemeinsamen Fischereipolitik darstellt und ein Vorschlag, diesen zu unterlaufen, rechtlich unzulässig wäre.
I want to know whether one can raise an objection of that kind to what is merely a report, not a legislative proposal, and whether that is something I can competently do on Thursday.	Ich möchte wissen, ob es möglich ist, einen Einwand gegen ein Dokument zu erheben, bei dem es sich lediglich um einen Bericht und keinen Legislativvorschlag handelt, und ob ich befugt bin, dies am Donnerstag zu tun.
That is precisely the time when you may, if you wish, raise this question, i.e. on Thursday prior to the start of the presentation of the report.	Genau dann können Sie, wenn Sie wollen, diese Frage ansprechen, d. h. am Donnerstag zu Beginn der Aussprache über den Bericht.
	Frau Präsidentin!
Madam President, coinciding with this year' s first part-session of the European Parliament, a date has been set, unfortunately for next Thursday, in Texas in America, for the execution of a young 34 year-old man who has been sentenced to death. We shall call him Mr Hicks.	Die erste diesjährige Tagung des Europäischen Parlaments fällt leider damit zusammen, daß in den Vereinigten Staaten, in Texas, für Donnerstag dieser Woche die Hinrichtung eines zum Tode verurteilten 34jährigen jungen Mannes namens Hicks festgelegt worden ist.
At the request of a French Member, Mr Zimeray, a petition has already been presented, which many people signed, including myself.	Auf Wunsch eines französischen Mitglieds, Herrn Zimeray, wurde bereits eine Petition eingereicht, die von vielen, auch von mir selbst, unterzeichnet worden ist.
However, I would ask you, in accordance with the line which is now constantly followed by the European Parliament and by the whole of the European Community, to make representations, using the weight of your prestigious office and the institution you represent, to the President and to the Governor of Texas, Mr Bush, who has the power to order a stay of execution and to reprieve the condemned person.	Gemäß der vom Europäischen Parlament und von der gesamten Europäischen Union nunmehr ständig vertretenen Linie möchte ich Sie jedoch bitten, den ganzen Einfluß Ihres Amtes und der Institution, die Sie vertreten, bei dem Präsidentschaftskandidaten und Gouverneur von Texas, George W. Bush, der zur Aussetzung der Vollstreckung des Todesurteils und zur Begnadigung des Verurteilten befugt ist, geltend zu machen.
This is all in accordance with the principles that we have always upheld.	All dies entspricht den Grundsätzen, die wir stets verteidigt haben.
Thank you, Mr Segni, I shall do so gladly.	Vielen Dank, Herr Segni, das will ich gerne tun.
Indeed, it is quite in keeping with the positions this House has always adopted.	Das ist ganz im Sinne der Position, die wir als Parlament immer vertreten haben.
Madam President, I should like to draw your attention to a case in which this Parliament has consistently shown an interest.	Frau Präsidentin! Ich möchte Sie auf einen Fall aufmerksam machen, mit dem sich dieses Parlament immer wieder befaßt hat.
It is the case of Alexander Nikitin.	Das ist der Fall von Alexander Nikitin.
All of us here are pleased that the courts have acquitted him and made it clear that in Russia, too, access to environmental information is a constitutional right.	Wir freuen uns hier alle, daß das Gericht ihn freigesprochen und deutlich gemacht hat, daß auch in Rußland der Zugang zu Umweltinformationen konstitutionelles Recht ist.
Now, however, he is to go before the courts once more because the public prosecutor is appealing.	Nun ist es aber so, daß er wieder angeklagt werden soll, weil der Staatsanwalt in Berufung geht.
We know, and we have stated as much in very many resolutions indeed, including specifically during the last plenary part-session of last year, that this is not solely a legal case and that it is wrong for Alexander Nikitin to be accused of criminal activity and treason because of our involvement as the beneficiaries of his findings.	Wir wissen und wir haben es in wirklich sehr vielen Entschließungen festgestellt - gerade während der letzten Plenartagung des vergangenen Jahres-, daß dies nicht nur ein juristischer Fall ist und daß es falsch ist, Alexander Nikitin Kriminalität und Verrat vorzuwerfen, weil wir als Betroffene von seinen Ergebnissen einen Nutzen haben.
These findings form the basis of the European programmes to protect the Barents Sea, and that is why I would ask you to examine a draft letter setting out the most important facts and to make Parliament's position, as expressed in the resolutions which it has adopted, clear as far as Russia is concerned.	Diese Ergebnisse sind die Grundlage für die europäischen Programme zum Schutz der Barentsee, und deswegen bitte ich Sie, einen Briefentwurf, der Ihnen die wichtigsten Fakten schildert, zu prüfen und im Sinne der Beschlüsse des Parlaments in Rußland diese Position deutlich zu machen.
Yes, Mrs Schroedter, I shall be pleased to look into the facts of this case when I have received your letter.	Frau Schroedter, ich bin gerne bereit, die damit zusammenhängenden Fakten zu prüfen, wenn mir Ihr Brief vorliegt.
Madam President, I would firstly like to compliment you on the fact that you have kept your word and that, during this first part-session of the new year, the number of television channels in our offices has indeed increased considerably.	Frau Präsidentin, zunächst besten Dank dafür, daß Sie Wort gehalten haben und nun in der ersten Sitzungsperiode des neuen Jahres das Angebot an Fernsehprogrammen in unseren Büros tatsächlich enorm erweitert ist.
But, Madam President, my personal request has not been met.	Dennoch, Frau Präsidentin, wurde meinem Wunsch nicht entsprochen.
Although there are now two Finnish channels and one Portuguese one, there is still no Dutch channel, which is what I had requested because Dutch people here like to be able to follow the news too when we are sent to this place of exile every month.	Zwar können wir jetzt zwei finnische und einen portugiesischen, nach wie vor aber keinen niederländischen Sender empfangen. Ich hatte Sie aber um ein niederländisches Programm gebeten, denn auch wir Niederländer möchten die Nachrichten verfolgen, wenn wir jeden Monat hierher in die Verbannung geschickt werden.
I would therefore once more ask you to ensure that we get a Dutch channel as well.	Deshalb möchte ich Sie nochmals ersuchen, dafür Sorge zu tragen, daß auch ein niederländischer Sender eingespeist wird.
Mrs Plooij-van Gorsel, I can tell you that this matter is on the agenda for the Quaestors' meeting on Wednesday.	Frau Plooij-van Gorsel, ich kann Ihnen mitteilen, daß dieser Punkt am Mittwoch auf der Tagesordnung der Quästoren steht.
It will, I hope, be examined in a positive light.	Ich hoffe, daß dort in Ihrem Sinne entschieden wird.
Madam President, can you tell me why this Parliament does not adhere to the health and safety legislation that it actually passes?	Frau Präsidentin, können Sie mir sagen, warum sich dieses Parlament nicht an die Arbeitsschutzregelungen hält, die es selbst verabschiedet hat?
Why has no air quality test been done on this particular building since we were elected?	Weshalb wurde die Luftqualität in diesem Gebäude seit unserer Wahl nicht ein einziges Mal überprüft?
Why has there been no Health and Safety Committee meeting since 1998?	Weshalb ist der Arbeitsschutzausschuß seit 1998 nicht ein einziges Mal zusammengetreten?
Why has there been no fire drill, either in the Brussels Parliament buildings or the Strasbourg Parliament buildings?	Warum hat weder im Brüsseler noch im Straßburger Parlamentsgebäude eine Brandschutzübung stattgefunden?
Why are there no fire instructions?	Warum finden keine Brandschutzbelehrungen statt?
Why have the staircases not been improved since my accident?	Warum wurde nach meinem Unfall nichts unternommen, um die Treppen sicherer zu machen?
Why are no-smoking areas not enforced?	Warum wird in den Nichtraucherzonen das Rauchverbot nicht durchgesetzt?
It seems absolutely disgraceful that we pass legislation and do not adhere to it ourselves.	Es ist eine Schande, daß wir Regeln verabschieden, an die wir uns dann selbst nicht halten.
Mrs Lynne, you are quite right and I shall check whether this has actually not been done.	Frau Lynne, Sie haben völlig recht, und ich werde prüfen, ob all dies wirklich so ist.
I shall also refer the matter to the College of Quaestors, and I am certain that they will be keen to ensure that we comply with the regulations we ourselves vote on.	Ich werde die Frage auch den Quästoren unterbreiten. Ich bin mir sicher, daß diese großen Wert darauf legen, daß wir die Rechtsvorschriften, die wir verabschieden, auch selbst einhalten.
Madam President, Mrs Díez González and I had tabled questions on certain opinions of the Vice-President, Mrs de Palacio, which appeared in a Spanish newspaper.	Frau Präsidentin! Frau Díez González und ich hatten einige Anfragen zu bestimmten, in einer spanischen Zeitung wiedergegebenen Stellungnahmen der Vizepräsidentin, Frau de Palacio, gestellt.
The competent services have not included them in the agenda on the grounds that they had been answered in a previous part-session.	Die zuständigen Dienste haben sie nicht in die Tagesordnung aufgenommen, da sie der Meinung waren, sie seien schon in einer vorangegangenen Sitzung beantwortet worden.
I would ask that they reconsider, since this is not the case.	Ich bitte, diese Entscheidung zu überdenken, weil das nicht der Fall ist.
The questions answered previously referred to Mrs de Palacio' s intervention, on another occasion, and not to these comments which appeared in the ABC newspaper on 18 November.	Die früher beantworteten Anfragen bezogen sich auf das Auftreten von Frau de Palacio in einer bestimmten Angelegenheit, nicht auf die am 18. November des vergangenen Jahres in der Tageszeitung ABC erschienenen Erklärungen.
Mr Berenguer Fuster, we shall check all this.	Lieber Kollege, wir werden das prüfen.
I admit that, at present, the matter seems to be somewhat confused.	Ich muß Ihnen aber sagen, daß ich die Lage im Moment für etwas verworren halte.
We shall therefore look into it properly to ensure that everything is as it should be.	Wir werden das aber sehr genau prüfen, damit alles seine Richtigkeit hat.
Madam President, I should like to know if there will be a clear message going out from Parliament this week about our discontent over today's decision refusing to renew the arms embargo on Indonesia, considering that the vast majority in this Parliament have endorsed the arms embargo in Indonesia in the past?	Frau Präsidentin, ich wüßte gern, ob das Parlament in dieser Woche ein deutliches Signal unserer Unzufriedenheit bezüglich der heutigen Entscheidung, mit der eine Verlängerung des Waffenembargos gegen Indonesien abgelehnt wird, aussenden wird, zumal sich die große Mehrheit in diesem Parlament in der Vergangenheit für das Waffenembargo gegen Indonesien ausgesprochen hat.
Today's decision not to renew the embargo is extremely dangerous considering the situation there.	Die heutige Entscheidung gegen eine Verlängerung des Embargos birgt angesichts der dortigen Lage eine sehr große Gefahr.
So Parliament should send a message, since that is the wish of the vast majority.	Das Parlament sollte, da dies dem Wunsch der großen Mehrheit entspricht, eine entsprechende Botschaft senden.
It is irresponsible of EU Member States to refuse to renew the embargo.	Die Ablehnung einer Verlängerung des Embargos seitens der EU-Mitgliedstaaten ist unverantwortlich.
As people have said, the situation there is extremely volatile.	Wie bereits festgestellt wurde, ist die Lage in Indonesien äußerst instabil.
There is, in fact, a risk of a military coup in the future.	Es besteht sogar die Gefahr eines Militärputsches.
We do not know what is happening.	Wir wissen nicht, was passiert.
So why should EU arms producers profit at the expense of innocent people?	Weshalb also sollten Waffenhersteller in der EU auf Kosten unschuldiger Menschen Profite einstreichen?
In any event, this question is not presently included among the requests for topical and urgent debate on Thursday.	Dieser Punkt ist bisher nicht für die Dringlichkeitsdebatte am Donnerstag vorgesehen.
Agenda	Arbeitsplan
The next item is the verification of the final version of the draft agenda as drawn up by the Conference of Presidents at its meeting of 13 January pursuant to Rule 110 of the Rules of Procedure.	Nach der Tagesordnung folgt die Prüfung des endgültigen Entwurfs der Tagesordnung, wie er nach Artikel 110 der Geschäftsordnung am Donnerstag, dem 13. Januar von der Konferenz der Präsidenten festgelegt wurde.
No amendments have been proposed relating to Monday and Tuesday.	Zu Montag und Dienstag liegen keine Änderungen vor.
Relating to Wednesday:	Zum Mittwoch:
The Group of the Party of European Socialists requests that a Commission statement be included on its strategic objectives for the next five years and on the administrative reform of the Commission.	Die Sozialdemokratische Fraktion beantragt, eine Erklärung der Kommission über ihre strategischen Ziele für die nächsten fünf Jahre sowie über die Verwaltungsreform der Kommission in die Tagesordnung aufzunehmen.
I would like Mr Barón Crespo, who made the request, to speak to propose it. That is, if he so wishes, of course.	Ich bitte den Antragsteller, Herrn Barón Crespo, seinen Antrag zu begründen, falls er dies wünscht.
Then we shall follow the usual procedure, hearing one speaker in favour and one against.	Danach verfahren wir wie üblich: ein Redner dafür, einer dagegen.
Madam President, the presentation of the Prodi Commission' s political programme for the whole legislature was initially a proposal by the Group of the Party of European Socialists which was unanimously approved by the Conference of Presidents in September and which was also explicitly accepted by President Prodi, who reiterated his commitment in his inaugural speech.	Frau Präsidentin! Die Vorstellung des politischen Programms der Kommission Prodi für die gesamte Wahlperiode ging auf einen Vorschlag der Fraktion der Sozialdemokratischen Partei Europas zurück, der die einhellige Billigung der Konferenz der Präsidenten im September und auch die ausdrückliche Zustimmung von Präsident Prodi fand, der seine Zusage in seiner Antrittsrede bekräftigte.
This commitment is important because the Commission is a body with a monopoly of initiative in accordance with the Treaties and, therefore, basically dictates this Parliament' s political and legislative activity for the next five years.	Diese Zusage ist insofern von Bedeutung, als die Kommission ein Organ ist, das nach den Verträgen das Initiativmonopol besitzt und somit grundlegend die politische und legislative Tätigkeit dieses Parlaments in den nächsten fünf Jahren gestaltet.
I would also like to point out, Madam President, that this Parliament voted to express its confidence in President Prodi during the previous legislature. It did so again during this legislature, in July, and then, in September, it voted once more to approve the whole Commission.	Ich möchte auch daran erinnern, daß dieses Parlament in der vorangegangenen Wahlperiode Präsident Prodi zweimal sein Vertrauen ausgesprochen hat; in dieser Wahlperiode sprach es ihm im Juli erneut sein Vertrauen aus, und dann, als die neue Kommission im Amt war, gab es im September erneut ein Vertrauensvotum für die Kommission insgesamt.
There has therefore been enough time for the Commission to prepare its programme and for us to become familiar with it and explain it to our citizens.	Somit hatte die Kommission bereits genügend Zeit, ihr Programm zu erarbeiten, und wir, um es kennenlernen und den Bürgern erklären zu können.
To this end, I would like to remind you of the resolution of 15 September, which recommended that the proposal be presented as soon as possible.	In diesem Sinne erinnere ich an die Entschließung vom 15. September, in der empfohlen wurde, den Vorschlag in der kürzestmöglichen Frist vorzulegen.
The events of last week - which originated outside the Conference of Presidents, that Conference being used simply to corroborate and ratify decisions taken elsewhere - present us with a dilemma. Either the Commission is not ready to present this programme, in which case it should clarify it.	Die Ereignisse der vergangenen Woche - die am Rande der Konferenz der Präsidenten ihren Anfang nahmen und wobei diese Konferenz nur zur Bestätigung und Ratifizierung von außerhalb gefaßten Beschlüssen genutzt wurde - verdeutlichen ein Dilemma: Entweder ist die Kommission nicht in der Lage, dieses Programm vorzulegen (In diesem Fall sollte sie eine Klärung herbeiführen.
According to its President, it is in a position to do so.	Nach den Worten ihres Präsidenten ist sie dazu in der Lage.
Given that the Commission is represented by Vice-President de Palacio, I believe that, before voting, it would help if the Commission could let us know how ready it is to present this programme, as agreed. Alternatively, Parliament is not ready to examine this programme, as some appear to be suggesting.	Da die Kommission durch die Vizepräsidentin, Frau de Palacio, vertreten ist, halte ich es für zweckmäßig, vor der Abstimmung die Position der Kommission hinsichtlich ihrer Bereitschaft zur Vorstellung des Programms, so wie es vereinbart war, zu erfahren.), oder das Parlament ist zur Prüfung dieses Programms nicht in der Lage, wie einige offenbar vorgeben.
In my opinion, this second hypothesis would imply the failure of Parliament in its duty as a Parliament, as well as introducing an original thesis, an unknown method which consists of making political groups aware, in writing, of a speech concerning the Commission' s programme a week earlier - and not a day earlier, as had been agreed - bearing in mind that the legislative programme will be discussed in February, so we could forego the debate, since on the next day our citizens will hear about it in the press and on the Internet and Parliament will no longer have to worry about it.	Nach meiner Ansicht würde diese zweite Hypothese einem Verzicht auf unsere Verantwortung als Parlament und darüber hinaus dem Aufwerfen einer originellen These, einer unbekannten Methode gleichkommen, die darin bestände, den Fraktionen die programmatische Rede der Kommission in schriftlicher Form eine Woche vorher - und nicht, wie vereinbart, am Tag zuvor - zur Kenntnis zu geben, wobei zu berücksichtigen ist, daß das Legislativprogramm im Februar diskutiert werden wird, so daß wir auf die Aussprache verzichten könnten, da die Presse und das Internet am Tag darauf alle Bürger darüber informiert haben würden und das Parlament keinen Grund mehr hätte, sich mit der Angelegenheit zu befassen.
My Group believes that since a parliament is meant to listen, debate and reflect, there can be no justification whatsoever for this delay and we believe that, if the Commission is ready to do so, we still have time to re-establish the original agreement between Parliament and the Commission and proceed in a manner which fulfils our duty to our fellow citizens.	Da meine Fraktion der Meinung ist, daß ein Parlament dazu da ist, zuzuhören, zu diskutieren und nachzudenken, gibt es unserer Ansicht nach keinen Grund zur Rechtfertigung dieser Verzögerung, und wir glauben, wenn die Kommission dazu in der Lage ist, liegen wir genau in der Zeit, um die ursprüngliche Vereinbarung zwischen dem Parlament und der Kommission wieder in Kraft zu setzen und verantwortungsbewußt vor unsere Mitbürgerinnen und Mitbürgern treten zu können.
Therefore, the proposal of the Group of the Party of European Socialists, and which you have mentioned, is that the Prodi Commission present its legislative programme on Wednesday, including its proposed administrative reform, because, otherwise, we could find ourselves in a paradoxical situation: on the pretext that there is no text, on the one hand, the President of the Commission would be denied his right to speak in this Parliament and, on the other hand, there would be a debate on a reform when Parliament had no prior knowledge of the texts on which it is based.	Deshalb besteht der Vorschlag der Fraktion der Sozialdemokratischen Partei Europas, den Sie erwähnt haben, darin, den Mittwoch als Termin der Vorstellung des Programms der Kommission Prodi für die Wahlperiode beizubehalten, und in dieses Programm auch das Verwaltungsreformprojekt einzubeziehen, da wir andernfalls in eine paradoxe Situation geraten könnten: Mit der Ausrede, der Wortlaut liege nicht vor, wird einerseits dem Präsidenten der Kommission das Recht abgesprochen, in diesem Parlament zu sprechen, und andererseits würde eine Aussprache über die Reform stattfinden, ohne daß dieses Parlament zuvor die Texte lesen konnte, die der Aussprache zugrunde liegen.
Therefore, Madam President, I would ask you to request that the Commission express its opinion on this issue and that we then proceed to the vote.	Daher bitte ich Sie, Frau Präsidentin, die Kommission zu ersuchen, sich jetzt zu äußern, und danach zur Abstimmung zu schreiten.
(Applause from the PSE Group)	(Beifall der PSE-Fraktion)
Madam President, I really am quite astonished at Mr Barón Crespo' s behaviour and the fact that he is now asking for this item to be put on Wednesday's agenda.	Frau Präsidentin, liebe Kolleginnen und Kollegen! Ich bin doch etwas erstaunt über das Verhalten des Kollegen Barón Crespo, der jetzt verlangt, daß dieser Tagesordnungspunkt auf die Tagesordnung für Mittwoch gesetzt wird.
Mr Barón Crespo, you were unable to attend the Conference of Presidents last Thursday.	Herr Kollege Barón Crespo, Sie konnten am letzten Donnerstag in der Konferenz der Präsidenten nicht anwesend sein.
I am not criticising this; it happens from time to time that people send someone to represent them.	Das kritisiere ich nicht; es kommt immer mal vor, daß man sich vertreten läßt.
Mr Hänsch represented you on this occasion.	Der Kollege Hänsch hat Sie dort vertreten.
In the Conference of Presidents, we had an in-depth discussion.	Wir haben in der Konferenz der Präsidenten eine ausführliche Debatte geführt.
Your Group was alone in advocating what you are saying now.	Nur Ihre Fraktion hat das vertreten, was Sie jetzt sagen.
We then put it to a vote.	Wir haben dann abgestimmt.
As you know, each chairman has the same number of votes as his Group has Members.	Jeder Vorsitzende bzw. jede Vorsitzende hat ja so viele Stimmen, wie die Fraktion Mitglieder hat.
There was a vote on this matter.	Es gab eine Abstimmung zu diesem Punkt.
As I recall, the outcome of this vote was 422 votes to 180 with a few abstentions.	Diese Abstimmung ist meiner Erinnerung nach so ausgegangen: 422 gegen 180 Stimmen bei einigen wenigen Enthaltungen.
This means that all the Groups with the exception of the non-attached Members - but, of course, they are not a Group - were in agreement; only your Group thought that we should proceed as you have proposed here.	Das heißt, alle Fraktionen, mit Ausnahme der Fraktionslosen - aber die sind ja keine Fraktion - waren sich einig, nur Ihre Fraktion war der Meinung, so zu verfahren, wie Sie es hier vorgeschlagen haben.
All of the others were of a different opinion.	Alle anderen waren anderer Meinung.
That was the decision.	Das war der Beschluß.
I should now like to comment on the issue itself.	Jetzt möchte ich zur Sache selbst etwas sagen.
We have confidence in the Commission and in Romano Prodi and, after a difficult procedure, as everyone knows, the vast majority of our Group supported the vote of confidence in Romano Prodi and the Commission.	Wir haben Vertrauen zur Kommission, zu Romano Prodi, und die ganz große Mehrheit unserer Fraktion hat Romano Prodi und der Kommission nach einem schwierigen Prozeß, wie jeder weiß, das Vertrauen ausgesprochen.
We believe, however, that the Commission's strategic plan needs to be debated within a proper procedural framework, not only on the basis of an oral statement here in the European Parliament, but also on the basis of a document which is adopted in the Commission and which describes this programme over the five-year period.	Aber wir sind auch der Meinung, daß wir eine Debatte über diese Strategie der Kommission in einem geordneten Verfahren führen müssen, nicht nur aufgrund einer mündlichen Erklärung hier im Europäischen Parlament, sondern auch aufgrund eines Dokumentes, das in der Kommission beschlossen ist und dieses Programm für fünf Jahre beschreibt.
There is no such document!	Ein solches Dokument gibt es nicht!
The Commission will present its programme for the year 2000 in February.	Die Kommission wird das Programm für das Jahr 2000 im Februar vorlegen.
We have said, very well, if the Commission does not wish to introduce the 2000 programme as early as January then we will do it in February.	Wir haben gesagt, o. k, wenn die Kommission das Programm 2000 noch nicht im Januar machen will, dann machen wir das im Februar.
We have agreed to this.	Wir haben dem zugestimmt.
After all, we do not wish to quarrel with the Commission; if at all possible, we believe that the Commission and Parliament need to tread the same path.	Wir wollen ja an sich keinen Streit mit der Kommission, sondern wir sind der Meinung, wenn es eben geht, müssen Kommission und Parlament einen gemeinsamen Weg gehen.
However, we in Parliament also have a supervisory role with regard to the Commission and we do not have to agree with everything which comes out of the Commission.	Aber wir als Parlament sind auch der Kontrolleur der Kommission. Und nicht alles, was von der Kommission kommt, muß unsere Meinung sein.
I should like us to be able to do a reasonable amount of preparation for the debate on the five-year programme in our Groups.	Ich möchte, daß wir uns auf eine Debatte über das Fünfjahresprogramm in den Fraktionen vernünftig vorbereiten können.
You cannot prepare if you hear a statement in this House and have no idea of its content.	Man kann sich nicht vorbereiten, wenn man hier eine Erklärung hört und gar nicht weiß, was Inhalt einer solchen Erklärung ist.
That is why we would recommend - and it is my impression that the Commission is also open to this idea - that we hold the debate on the Commission's long-term programme up to the year 2005 in February - and I hope that the Commission will agree on a programme before then which it will propose to us - and that, at the same time, in February we also hold the debate on the Commission's legislative programme for the year 2000.	Deswegen ist es unsere Empfehlung - und mein Eindruck ist, daß die Kommission auch aufgeschlossen ist für diesen Gedanken -, daß wir im Februar die Debatte über das langfristige Programm der Kommission bis zum Jahre 2005 führen - ich hoffe, die Kommission wird sich bis dahin auch auf ein Programm verständigen, das sie uns vorschlagen wird -, und daß wir gleichzeitig im Februar auch die Debatte über das Legislativprogramm der Kommission für das Jahr 2000 führen.
The fact that the subjects are connected also suggests that we should hold the debate on both programmes together.	Es ist also auch ein vernünftiger sachlicher Zusammenhang, der uns rät, die Debatte über beide Programme gemeinsam zu führen.
That is why my Group firmly rejects the proposal made by the Socialist Group.	Deswegen lehnt meine Fraktion den Vorschlag der Sozialistischen Fraktion entschieden ab!
(Applause from the PPE-DE Group)	(Beifall von der PPE-DE-Fraktion)
I propose that we vote on the request of the Group of the Party of European Socialists that the Commission statement on its strategic objectives should be reinstated.	Ich schlage vor, daß wir über den Antrag der Sozialdemokratischen Fraktion, die Erklärung der Kommission über ihre strategischen Ziele wieder auf die Tagesordnung zu setzen, abstimmen.
(Parliament rejected the request) President.	(Das Parlament lehnt den Antrag ab.) Die Präsidentin.
Still on the subject of Wednesday' s sitting, I have another proposal regarding the oral question on capital tax.	Zum Mittwoch liegt mir noch ein weiterer Antrag betreffend die mündliche Anfrage über die Kapitalsteuer vor.
The PPE-DE Group is requesting that this item be taken off the agenda.	Die PPE/DE-Fraktion beantragt, diesen Punkt von der Tagesordnung abzusetzen.
Is there a member who wishes to speak on behalf of this Group to propose this?	Möchte jemand den Antrag im Namen der Fraktion begründen?
Madam President, I can hear a ripple of laughter from the Socialists. I was told that large sections of the Socialist Group were also keen to have this item taken off the agenda, because at the vote in the Conference of Presidents no vote was received from the working group of Members of the Socialist Group responsible for this matter.	Frau Präsidentin, da ich bei den Sozialisten ein bißchen Gelächter höre - mir wurde gesagt, daß auch weite Kreise der Sozialistischen Fraktion diesen Tagesordnungspunkt gern abgesetzt haben wollen, weil bei der Abstimmung in der Konferenz der Präsidenten das Votum der Arbeitsgruppe der zuständigen Kolleginnen und Kollegen der Sozialistischen Fraktion nicht vorlag.
I do not know whether this information is correct, but the PPE-DE Group would, in any case, be grateful if this item were removed because Parliament has addressed this issue several times already.	Ich weiß nicht, ob diese Information richtig ist, aber wir als EVP-ED-Fraktion wären jedenfalls dankbar, wenn dieser Punkt abgesetzt würde, weil sich das Parlament nämlich schon mehrfach mit dieser Frage befaßt hat.
Decisions have also been adopted against a tax of this kind.	Es gibt auch Beschlüsse gegen eine solche Steuer.
That is why my Group moves that this item be taken off the agenda.	Deswegen beantragt meine Fraktion, diesen Punkt von der Tagesordnung abzusetzen.
Thank you, Mr Poettering.	Vielen Dank, Herr Poettering.
We shall now hear Mr Wurtz speaking against this request.	Wir kommen nun zu Herrn Wurtz, der gegen den Antrag spricht.
Madam President, I would firstly like to point out Mr Poettering' s lack of logic.	Frau Präsidentin, ich möchte zunächst darauf hinweisen, daß das, was Herr Poettering da sagt, nicht ganz logisch ist.
He has just been preaching to the Group of the Party of European Socialists because they went back on a decision taken in a perfectly clear manner at the Conference of Presidents, and now he is doing just the same.	Zum einen belehrt er die Sozialdemokratische Fraktion, weil diese eine ganz klare und eindeutige Entscheidung der Konferenz der Präsidenten in Frage stellt. Und nun tut er genau dasselbe.
We discussed that matter and we were unanimous, with the exception of the PPE and ELDR Groups.	Wir haben diskutiert, wir waren uns einig, nur die EVP-Fraktion und die Liberalen nicht.
As my fellow chairmen will recall, I even mentioned that it was not a matter of knowing whether one was for or against the Tobin tax, but of whether one dared to hear what the Commission and the Council thought of it.	Und ich hatte noch darauf hingewiesen, die anderen Präsidentenkollegen werden sich noch daran erinnern, daß es nicht darum geht, ob man für oder gegen die Tobin-Steuer ist, sondern darum, ob wir bereit sind, uns anzuhören, was die Kommission und der Rat davon halten.
It is not a lot to ask.	Das ist nicht zuviel verlangt.
I therefore repeat the proposal that this oral question to the Commission and the Council should be retained so that we can find out, once and for all, the positions of these two bodies regarding the proposal which is relatively modest but which would give a clear message to public opinion, particularly after the tide of feeling generated by the failure of the Seattle Conference.	Ich wiederhole also den Vorschlag, diese mündliche Anfrage an die Kommission und den Rat aufrechtzuerhalten, um ein für alle Mal die Meinung dieser beiden Institutionen zu diesem relativ bescheidenen Vorschlag zu erfahren, der für die Öffentlichkeit ein wichtiges Signal wäre, insbesondere nach der Aufregung im Gefolge des Scheiterns der Konferenz von Seattle.
We shall proceed to vote on the PPE-DE Group' s request that the oral question regarding the capital tax be withdrawn from the agenda.	Wir stimmen jetzt über den Antrag der PPE/DE-Fraktion ab, die mündliche Anfrage über die Kapitalsteuer von der Tagesordnung abzusetzen.
(Parliament rejected the request, with 164 votes for, 166 votes against and 7 abstentions)	(Das Parlament lehnt den Antrag mit 164 Ja-Stimmen, 166 Nein-Stimmen und 7 Enthaltungen ab.)
Madam President, I would like to thank Mr Poettering for advertising this debate.	Frau Präsidentin, ich möchte Herrn Poettering für das Rühren der Werbetrommel zugunsten dieser Aussprache danken.
Thank you very much.	Vielen Dank.
Madam President, has my vote been counted?	Frau Präsidentin! Ist meine Stimme mitgezählt worden?
I was unable to vote electronically, since I do not have a card.	Ich konnte sie nämlich nicht elektronisch abgeben, weil ich die Karte nicht habe.
My vote was "in favour" .	Ich habe "dafür " gestimmt.
Indeed, if we add the two Members who have declared themselves, then the result of the vote would be ....	In der Tat, wenn man die beiden Mitglieder, die sich gemeldet haben hinzuzählt, dann ergibt sich als Ergebnis ...
Madam President, the Presidency has already declared the result of the vote.	Frau Präsidentin! Die Präsidentschaft hat das Ergebnis der Abstimmung verkündet.
There is no room for amendments.	Änderungen sind nicht möglich.
Madam President, in the earlier vote - and I will abide by your ruling on this matter - on the question of the strategic plan of the Commission I indicated that I would like to speak in advance of the vote on behalf of my Group.	Frau Präsidentin, bei der früheren Abstimmung zur Frage des Strategieplans der Kommission - keine Angst, ich werde mich an Ihre Entscheidung in dieser Sache halten - hatte ich darum gebeten, vor der Abstimmung im Namen meiner Fraktion sprechen zu dürfen.
That did not happen.	Dazu kam es nicht.
I would appreciate it if, on the close of this item of business, I might be allowed to give an explanation of vote on behalf of my Group.	Ich würde es begrüßen, wenn ich zum Abschluß dieses Geschäftspunktes die Möglichkeit hätte, im Namen meiner Fraktion eine Erklärung zur Abstimmung abzugeben.
This is an important matter.	Das ist eine wichtige Angelegenheit.
It would be useful for the record of the House to state how people perceive what we have just done in the light of their own political analysis.	Vielleicht wäre es sinnvoll festzuhalten, wie das, was wir eben getan haben, von den einzelnen vor dem Hintergrund ihrer eigenen politischen Analyse aufgenommen wird.
Madam President, I do not wish to reopen the debate, but I had also asked for the floor, to comment on Mr Barón Crespo's motion.	Frau Präsidentin! Ich will die Debatte nicht wieder aufnehmen, aber ich hatte mich auch gemeldet, um zu dem Antrag von Herrn Barón Crespo Stellung zu nehmen.
You did not call me either.	Sie haben mich auch nicht aufgerufen.
I regret this, but the vote has already been taken and the decision is made so let us leave the matter there.	Ich bedauere das, aber die Abstimmung ist durchgeführt worden, die Entscheidung ist gefallen, also lassen wir die Dinge.
I am terribly sorry, Mr Hänsch and Mr Cox.	Das tut mir leid, Herr Hänsch und Herr Cox.
I did not see you asking to speak.	Ich hatte nicht gesehen, daß Sie ums Wort gebeten hatten.
Even so, I think the positions are quite clear and they shall be entered in the Minutes.	Doch die Positionen sind deutlich geworden und werden ins Protokoll aufgenommen.
When we adopt the Minutes for today' s sitting tomorrow, then any Members who think the positions have not been explained clearly enough may ask for amendments.	Wenn wir morgen das Protokoll der Sitzung von heute verabschieden, können die Kolleginnen und Kollegen, die der Auffassung sind, daß die Positionen nicht ausreichend klar geworden sind, Änderungen beantragen.
This seems to me to be a workable solution.	Ich halte dieses Vorgehen für angemessen.
Of course, the Minutes for tomorrow' s sitting will take into account any additional explanations.	Natürlich werden im Protokoll der Sitzung von morgen sämtliche zusätzlichen Erläuterungen berücksichtigt.
I think this is a better solution than proceeding now to extremely time-consuming explanations of votes.	Ich halte das für besser als jetzt lange Stimmerklärungen abzugeben.
Mr Cox, Mr Hänsch, would this be acceptable to you?	Herr Cox, Herr Hänsch, sind Sie damit einverstanden?
Madam President, if the vote records correctly how my Group voted I shall not, and cannot, object to that.	Frau Präsidentin, wenn aus der Abstimmung einwandfrei hervorgeht, wie meine Fraktion abgestimmt hat, dann werde und kann ich nichts dagegen sagen.
If your ruling is that I cannot give an explanation of vote, I accept that but with reservations.	Wenn Sie festlegen, daß ich keine Erklärung zur Abstimmung abgeben kann, akzeptiere ich das, wenngleich unter Vorbehalt.
We shall pay particular attention to the wording of the Minutes, as we always do, of course.	Beim Abfassen des Protokolls werden wir mit großer Sorgfalt vorgehen. Das tun wir im übrigen immer.
If they do not properly reflect the positions adopted, then we may correct them, if necessary.	Wenn Positionen nicht richtig wiedergegeben werden, können wir das Protokoll gegebenenfalls ändern.
(The order of business was adopted thus amended)	(Das Parlament genehmigt den geänderten Arbeitsplan.)
Safety advisers for the transport of dangerous goods	Sicherheitsberater für den Gefahrguttransport
The next item is the report (A5-0105/1999) by Mr Koch, on behalf of the Committee on Regional Policy, Transport and Tourism, on the common position adopted by the Council with a view to adopting a European Parliament and Council directive on the harmonisation of examination requirements for safety advisers for the transport of dangerous goods by road, rail or inland waterways (C5-0208/1999 - 1998/0106(COD)).	Nach der Tagesordnung folgt der Bericht (A5-0105/1999) von Herrn Koch im Namen des Ausschusses für Regionalpolitik, Verkehr und Fremdenverkehr über den Gemeinsamen Standpunkt des Rates im Hinblick auf den Erlaß der Richtlinie des Europäischen Parlaments und des Rates über die Mindestanforderungen für die Prüfung der Sicherheitsberater für die Beförderung gefährlicher Güter auf Straße, Schiene oder Binnenwasserstraßen (C5-0208/1999 - 1998/0106(COD)).
Commissioner, Madam President, ladies and gentlemen, I can be quite frank in saying that I welcome the Council's common position on harmonising the training of safety advisers for the transport of dangerous goods by road, rail or inland waterway.	Verehrte Frau Kommissarin, verehrte Präsidentin, liebe Kolleginnen und Kollegen! Ich begrüße den Gemeinsamen Standpunkt des Rates zur Harmonisierung der Ausbildung von Sicherheitsberatern für die Beförderung gefährlicher Güter auf Straße, Schiene oder Binnenwasserstraße unumwunden.
Firstly, we needed to take action on a formal level in order to meet the requirements of Directive 96/35/EC, which obliges the Member States to appoint safety advisers and to organise the training, instruction and examination of these people but does not explain this explicitly.	Erstens: Wir mußten formal tätig werden, um den Forderungen der Richtlinie 96/35/EG gerecht zu werden, die die Mitgliedstaaten zur Einsetzung von Gefahrgutbeauftragten bzw. Sicherheitsberatern sowie zur Organisation von Ausbildung, Schulung und Prüfung eben dieser Personen verpflichtet, ohne dies explizit auszuführen.
Secondly, by adopting this directive we achieve a) an increase in safety when dangerous goods are both transported and transhipped; b) a reduction in distortions of competition resulting from wide variations in national training structures and training costs and c) equal opportunities for safety advisers on the European labour market.	Zweitens: Wir erzielen mit dieser Richtlinie a) ein Mehr an Sicherheit, sowohl bei der Beförderung als auch beim Umschlag von gefährlichen Gütern; b) einen Abbau von Wettbewerbsverzerrungen infolge unterschiedlichster nationaler Ausbildungsstrukturen und Ausbildungskosten sowie c) die Herstellung der Chancengleichheit von Sicherheitsberatern auf dem europäischen Arbeitsmarkt.
Thirdly, this directive, as it currently stands in the common position, guarantees - in particular because it confines itself exclusively to minimum standards - a high degree of flexibility and modest regulation by the European Union; by adopting it we contribute to the Member States' bearing a high level of individual responsibility.	Drittens garantieren wir mit der Richtlinie, so wie sie jetzt als Gemeinsamer Standpunkt vorliegt, insbesondere da sie sich ausschließlich auf Mindestnormen beschränkt, einen hohen Flexibilitätsgrad und geringe Reglementierung durch die Europäische Union, und wir tragen zur hohen Eigenverantwortung der Mitgliedstaaten bei.
All of this is in accordance with the principle of subsidiarity and is therefore to be greatly welcomed.	All dies ist im Sinne der Subsidiarität außerordentlich zu begrüßen.
Our amendments from the first reading have, I believe, been taken into account very satisfactorily.	Unsere Änderungsanträge aus der ersten Lesung halte ich für sehr zufriedenstellend berücksichtigt.
They have either been accepted or transposed with no change in the substance, or they have been rejected because the corresponding European arrangements have not been included, for example a system of penalties for violations of the rules or a complex classification structure for related groups of questions.	Sie wurden übernommen, sinngemäß umgesetzt bzw. sie entfielen, weil die entsprechenden europäischen Regelungen nicht aufgenommen wurden, z. B. ein Sanktionssystem bei Verstößen oder eine komplizierte Blockbildung von Fragenkomplexen.
The one unanimously adopted amendment of the Committee on Regional Policy and Transport, which concerns the timetable for implementing the directive, is something which I would urge you to support.	Für den einen einstimmig angenommenen Änderungsantrag des Ausschusses für Regionalpolitik und Verkehr, der die zeitliche Umsetzung der Richtlinie betrifft, bitte ich um Zustimmung.
By not setting a specific date for the Member States to implement the directive and instead giving them a period of three months after its entry into force, we are introducing a flexibility clause which ensures that the directive will be implemented without delay.	Indem wir den Mitgliedstaaten für die Umsetzung der Richtlinie kein spezifisches Datum setzen, sondern ihnen einen Zeitraum von drei Monaten nach Inkrafttreten der Richtlinie zugestehen, führen wir eine Flexibilitätsklausel ein, die eine unverzügliche Umsetzung gewährleistet.
I would urge you to endorse this.	Ich bitte Sie um Zustimmung.
Madam President, we cannot and must not accept the fact that we hear ever more frequently of accidents causing major damage on our roads, but also on our railways and waterways, not solely but at least partly because those involved do not take the transport of dangerous goods seriously enough or because - as a result of ignorance or a lack of training on the part of the drivers or others responsible for the various vehicles - a minor accident has all too often become a major disaster.	Frau Präsidentin! Wir können und dürfen uns nicht damit abfinden, immer häufiger von Unfällen zu hören, bei denen auf der Straße, aber auch auf der Schiene oder auf Wasserwegen große Schäden entstehen, nicht nur, aber auch, weil die Betroffenen den Transit von gefährlichen Gütern nicht ernst genug nehmen oder weil durch Unwissen oder aufgrund mangelnder Ausbildung der Fahrer oder sonstiger Verantwortlicher für die diversen Verkehrsmittel aus einem kleinen Unfall allzu oft eine große Katastrophe geworden ist.
As an Austrian, I still have a vivid memory, as, I believe, we all do, of the catastrophe which cost so many human lives last year in the Tauern Tunnel, where subsequent work to rebuild the parts of the tunnel which had been destroyed in this fire continued for many months at huge expense.	Mir als Österreicher, aber ich glaube, uns allen ist noch die Katastrophe in lebendiger Erinnerung, die im vergangenen Jahr im Tauerntunnel zahlreiche Menschenleben gekostet hat und wo anschließend viele Monate lang mit gigantischem finanziellem Aufwand wiederaufgebaut werden mußte, was bei diesem Brand im Tunnel zerstört worden ist.
The renovation project, which lasted for months, cut off this important route between the north and south of Europe.	Die monatelange Renovierung hat diesen wichtigen Verkehrsweg zwischen dem Norden und dem Süden Europas abgeschnitten.
The traffic which had to be diverted because of this stretched the patience of many thousands of people in the EU to the limit.	Der dadurch bewirkte Umwegsverkehr hat viele Tausend EU-Bürger bis an die Grenze des Erträglichen belastet.
In fact, all hell broke loose in some municipalities in my province.	Es war in einzelnen Gemeinden in meinem Land wirklich die Hölle los.
Prevention has to be our answer to disasters of this kind and this draft directive is an important step towards well-trained safety advisers being available, so that the right action is taken in good time.	Prävention muß unsere Antwort auf derartige Katastrophen sein, und mit dem vorliegenden Richtlinienentwurf schaffen wir eine wichtige Grundlage dafür, daß gut ausgebildete Sicherheitsbeauftragte zur Verfügung stehen, damit rechtzeitig das Richtige getan wird.
All the same, we must not content ourselves with enacting European law to ensure greater safety.	Wir dürfen uns freilich nicht damit begnügen, europäisches Recht im Dienste von mehr Sicherheit zu schaffen.
We also need to follow this up and make sure that our rules are transposed by the Member States in good time and - even more importantly - we need to ensure that they are also applied afterwards.	Wir müssen auch konsequent darauf achten, daß unsere Vorgaben fristgerecht durch die Mitgliedstaaten umgesetzt werden, und noch wichtiger, wir müssen darauf achten, daß sie anschließend auch angewendet werden.
Please let this not be yet another sector where we subsequently have to lament the lack of enforcement.	Bitte nicht noch einen weiteren Bereich, in dem wir dann anschließend das Vollzugsdefizit beklagen müssen.
I should like to address one final point. We must not content ourselves with sealing another hole in the safety net and shutting our eyes to the fact that, where transport safety in Europe is concerned, there is still much more to be done.	Einen letzten Punkt möchte ich noch ansprechen: Wir dürfen uns nicht damit begnügen, eine weitere Lücke im Sicherheitsnetz zu schließen und die Augen davor zu verschließen, daß beim Thema Verkehrssicherheit in Europa noch viel mehr zu tun ist.
In this context, I should like to make a request and ask the Commissioner responsible, who is with us here today, to table an appropriate text as soon as possible with a view to continuing to make it safer for traffic to transit tunnels in the future, so that we in Europe do not have to experience any more such disasters on this scale.	Ich verlange in diesem Zusammenhang auch und bitte die anwesende zuständige Kommissarin, möglichst bald einen entsprechenden Text vorzulegen, um auch in Zukunft für mehr Sicherheit im Tunnelverkehr zu sorgen, damit wir in Europa solche Katastrophen nicht mehr in diesem Ausmaß erleben müssen!
Madam President, first of all I should like to thank Mr Koch for his report which has, at its heart, the issue of transport safety.	Frau Präsidentin, zunächst möchte ich Herrn Koch für seinen Bericht danken, der die Verkehrssicherheit zum Thema hat.
The report looks at the issue of harmonising the examination requirements for safety advisors working in the areas of transportation of dangerous goods by road, rail and inland waterway.	Der Bericht befaßt sich mit der Harmonisierung von Prüfungsanforderungen für Sicherheitsberater, die im Bereich der Beförderung gefährlicher Güter auf Straße, Schiene oder Binnenwasserstraße tätig sind.
I congratulate him on his excellent report.	Ich beglückwünsche ihn zu seinem ausgezeichneten Bericht.
Transport safety has sadly been in the news recently: the Paddington rail crash in London, the terrible rail crash in Norway, the two aviation crashes involving EU citizens and the natural disaster involving the Erika off Brittany - all within the last four months - remind us that transport safety can never be taken for granted and that those charged with protecting the public must be highly motivated and highly qualified.	Die Verkehrssicherheit bestimmte in letzter Zeit häufig die Negativschlagzeilen: Das Eisenbahnunglück nahe dem Londoner Bahnhof Paddington, das furchtbare Eisenbahnunglück in Norwegen, zwei Flugzeugabstürze, bei denen EU-Bürger zu Schaden kamen, und die von der Erika vor der bretonischen Küste verursachte Naturkatastrophe sind Ereignisse, die allein in den letzten vier Monaten zu verzeichnen waren. Sie machen deutlich, daß Verkehrssicherheit keine Selbstverständlichkeit ist und daß diejenigen, die für den Schutz der Öffentlichkeit verantwortlich sind, hochmotiviert und hochqualifiziert sein müssen.
The rapporteur has pointed out to the House that in its common position the Council has accepted six of Parliament's ten amendments put forward at first reading and that the substance of Parliament's other amendments has been retained.	Der Berichterstatter stellte fest, daß der Rat in seinem Gemeinsamen Standpunkt sechs der zehn vom Parlament in der ersten Lesung angenommenen Änderungen übernommen hat und daß die übrigen Änderungen des Parlaments im wesentlichen berücksichtigt worden sind.
My Group will therefore support the common position and looks forward to the enactment of the legislation which will provide us with yet another tool in our fight to make transport in the European Union as safe as possible.	Meine Fraktion wird den Gemeinsamen Standpunkt daher unterstützen und begrüßt die baldige Umsetzung der Regelung, die ein weiteres Instrument im Kampf um die maximale Erhöhung der Verkehrssicherheit in der EU darstellen wird.
When it comes to safety my Group will always support any initiatives to improve transport safety.	Initiativen zur Erhöhung der Verkehrssicherheit werden jederzeit von meiner Fraktion unterstützt.
We still have a lot of work to do in this area as recent events have proved.	Wie die jüngsten Ereignisse zeigen, gibt es in diesem Bereich noch sehr viel zu tun.
Madam President, I would like to make a few comments.	Frau Präsidentin, gestatten Sie mir einige Bemerkungen.
I would like, first of all, to thank the rapporteur for his exceptionally accurate and technical work on the report and, secondly, the Commission for the proposal it has submitted.	Danken möchte ich sowohl dem Berichterstatter für seinen überaus akribischen und sachkundigen Bericht als auch der Kommission für den von ihr eingebrachten Vorschlag.
We are concerned here with the harmonisation of examination requirements but also, in fact, with minimum requirements.	Es geht um die Angleichung der Prüfungsvorschriften, eigentlich aber auch um Mindestnormen.
This is a pity, in a sense.	In gewissem Sinne bedauere ich das.
Needless to say, safety on roads, railways and inland waterways is of key importance and, given the international nature of these types of transport, training for safety advisors should also be harmonised, therefore, as well as the requirements of the new ADR, for example, which is under way.	Selbstverständlich kommt der Verkehrssicherheit auf Straße, Schiene oder Binnenwasserstraßen überaus große Bedeutung zu, und angesichts des internationalen Charakters dieser Transporte ist es erforderlich, die Ausbildungsgänge für Sicherheitsberater sowie die Anforderungen beispielsweise im kommenden neuen ADR zu harmonisieren.
This is important, but so is enforcement and there are, of course, a number of reasons why we need to pay particular attention to this.	Das halte ich ebenso wie die Umsetzung für wichtig. Natürlich gibt es gute Gründe, weshalb wir diesem Problem besondere Aufmerksamkeit widmen müssen.
Just think of the road accidents which have occurred over recent years, for example in Belgium, the Netherlands and a number of other countries where lorries carrying dangerous goods continued to drive in foggy conditions when really they should have pulled off the road instead.	Denken Sie an die Unfälle, die sich in den letzten Jahren im Straßenverkehr ereignet haben. Beispielsweise in Belgien, den Niederlanden und weiteren Ländern fuhren Gefahrguttransporter trotz Nebels weiter und wurden nicht, wie es angesichts der Umstände eigentlich erforderlich gewesen wäre, am Straßenrand abgestellt.
Or ships from Eastern Europe which moor adjacent to ships over here, with all the obvious risks that this entails.	Oder denken Sie an Schiffer von osteuropäischen Schiffen, die hier neben anderen ankern und von denen ganz offensichtlich Gefahren ausgehen.
Furthermore, it has transpired that research in the ports in Belgium, Finland, but also in Japan has shown that 50% of containers with partially dangerous cargo are not delivered correctly for shipment.	Außerdem belegen Kontrollen in belgischen, finnischen wie auch in japanischen Häfen, daß 50 % der Container mit zum Teil gefährlicher Ladung nicht ordnungsgemäß angeliefert werden.
In short, the issue is an important one.	Kurzum, ein ernstes Problem.
If we look at the situation where safety advisers are concerned, in a number of countries it is compulsory to employ such safety advisers in companies as from 1 January of this year.	Was die Sicherheitsberater betrifft, so ist in einigen Ländern seit dem 1. Januar dieses Jahres ein solcher Berater in den Unternehmen vorgeschrieben.
There will be major problems with enforcing this rule at present, especially with smaller companies, as these cannot afford safety advisors.	Die Umsetzung ist gegenwärtig insbesondere in kleinen Betrieben mit Schwierigkeiten verbunden, denn sie können sich eine solche Stelle nicht leisten.
These smaller companies either dispose of their cargo or mix it with other cargo, which causes problems.	Entweder sie verkaufen ihre Ladung oder mischen sie mit anderer Ladung, was zu einer Reihe von Problemen führt.
It is therefore also being requested that ISO 9002 certificates possibly include the finer details of these activities in the form of annual reports and company analyses.	Gefordert werden deshalb auch die Erfassung dieser Aktivitäten in Form von Jahresberichten oder Betriebsanalysen und eventuell die Einbeziehung in die Zertifizierung nach ISO 9002.
The work is done. All that remains is the business of enforcement.	Die eigentliche Arbeit ist getan, nun geht es um die Umsetzung.
I would like to mention one final point.	Gestatten Sie mir noch einen letzten Hinweis.
With regard to enforcement, proper agreements must also be concluded with the Eastern European countries because they will not enter into treaties which deal with this matter until 1 July 2001, that is to say in eighteen months' time.	Im Hinblick auf diese Umsetzung müssen wir außerdem angemessene Vereinbarungen mit den osteuropäischen Ländern treffen, da sie erst ab 1. Juli 2001, also in anderthalb Jahren, den entsprechenden Übereinkommen beitreten werden.
This gives them a competitive edge for the interim period.	Dadurch erwachsen ihnen vorübergehend Wettbewerbsvorteile.
This is not in itself anything dreadful, but we should prioritise particularly the safety aspects for goods transported by road, rail and inland waterways and incorporate these, as part of the acquis communautaire, as soon as possible and present them to the acceding states.	Obgleich ich das an sich nicht schlimm finde, sollten wir insbesondere den Sicherheitsaspekten des Gefahrguttransports auf Straße, Schiene und Binnenwasserstraßen Priorität einräumen, diesen Teil des Besitzstands so bald als möglich aufgreifen und den beitrittswilligen Staaten vorlegen.
Madam President, the importance of transport safety is highlighted on a regular basis in this Parliament and rightly so.	Frau Präsidentin, zu Recht befaßt sich das Parlament regelmäßig mit der Verkehrssicherheit.
The ever increasing volume of goods passing through Europe entails all kinds of risks, known and unknown, for employees and the social environment.	Die ständig zunehmende Menge an Gütern, die durch Europa befördert werden, stellt offen oder versteckt eine Gefahr für das Personal und die Gesellschaft dar.
Those having to deal with these risks should therefore meet stringent requirements.	Personen, die mit dieser Gefahr konfrontiert sind, haben deshalb hohen Anforderungen zu genügen.
The relevant standards which have been laid down in another Directive, 95/35/EC, seem sufficiently adequate to advise people in a responsible manner on the organisation of the transport of dangerous goods.	Mit den dazu in einer anderen Richtlinie, 95/35/EG, verankerten Normen sollten Menschen verantwortungsbewußt über die Beförderung gefährlicher Güter beraten werden können.
I am very pleased that agreement has also been reached with the Council on minimum standards regarding examinations, although I would have preferred it if uniform, set standards and modules had been established, so that certificates would be of equal value internationally.	Zu meiner Freude besteht auch mit dem Rat Übereinstimmung über Mindestanforderungen für deren Prüfung, obgleich ich mit dem Ziel international gleichwertiger Befähigungsnachweise einheitliche verbindliche Normen und Regelungen bevorzugt hätte.
This, however, does not seem feasible.	Allerdings scheint das nicht machbar zu sein.
Finally, the amendment tabled by the rapporteur is perfectly logical and I can, therefore, give it my wholehearted support.	Summa summarum halte ich den von dem Berichterstatter eingebrachten Abänderungsantrag in jeder Hinsicht für logisch und kann ihn deshalb voll und ganz unterstützen.
Mr President, Commissioner, I should first like to congratulate Mr Koch on his reports which, though technical, are nonetheless of very great significance for safety.	Herr Präsident, Frau Kommissarin, liebe Kolleginnen und Kollegen! Ich möchte zuerst dem Kollegen Koch zu seinen Berichten gratulieren, die vielleicht technische Berichte sind, aber für die Sicherheit von sehr großer Bedeutung sind.
I should like to make just a few comments.	Ich möchte nur wenige Anmerkungen machen.
Firstly, I should like to ask the Commissioner - and I am convinced that my request will fall on fertile ground - to ensure that more attention is paid to the issue of safety, be it on the roads, on the waterways or at sea.	Zuerst möchte ich die Frau Kommissarin bitten - und ich bin überzeugt, daß mein Wunsch auf fruchtbaren Boden fällt -, daß man der Frage der Sicherheit, ob auf der Straße, auf den Wasserwegen oder auf dem Meer, erhöhte Aufmerksamkeit schenkt.
Considering that it is only today that we are dealing with a Commission proposal first made on 19 March 1998, even though Parliament responded relatively quickly, this time lag is a little too long.	Wenn ich sehe, daß der erste Antrag der Kommission am 19. März 1998 gestellt wurde und wir uns heute damit beschäftigen - wobei das Parlament relativ rasch reagiert hat -, dann ist dieser Zeitraum etwas zu lang.
This is not just the fault of the Commission, but I believe that we need to take action more quickly so as to achieve harmonisation in this area as well.	Das ist jetzt nicht allein die Schuld der Kommission, aber ich glaube, daß wir rascher reagieren müssen, um hier auch zu einer Harmonisierung zu kommen.
My second point has already been mentioned: it concerns the minimum standards.	Der zweite Punkt wurde bereits erwähnt: die Mindestnormen.
In principle, I believe that in many cases where transport is concerned we should be working towards increased flexibility and country-specific rules.	Ich bin grundsätzlich der Meinung, daß wir in vielen Verkehrsbereichen erhöhte Flexibilität und länderweise Regelungen anstreben sollten.
However, when it comes to safety, I am rather sceptical because safety in Sweden, for example, is in principle no different from safety in Germany, Italy or Austria.	Bei der Sicherheit bin ich schon etwas skeptisch, weil sich die Sicherheit etwa in Schweden im Grundsatz nicht von der in Deutschland, Italien oder Österreich unterscheidet.
I can live with these minimum standards, but I would ask the Commission to monitor the situation very carefully.	Ich kann mit diesen Mindestnormen leben, aber ich bitte die Kommission, die Dinge wirklich aufmerksam zu verfolgen.
Should flexibility of this kind result in there being inadequate rules in some countries then we should work towards greater harmonisation.	Falls diese Art der Flexibilität zu ungenügenden Regelungen in einigen Ländern führen sollte, dann sollten wir eine weitere Harmonisierung vornehmen.
My third point has also been mentioned already.	Der dritte Punkt wurde auch schon erwähnt.
As you know, like Mr Rack, I come from a transit country, where this issue plays a particularly important role.	Ich komme ja ähnlich wie der Kollege Rack aus einem Transitland, wo diese Frage eine besondere Rolle spielt.
We do not want to make the conditions of competition worse for some countries unilaterally and improve them for countries such as Austria or other transit countries.	Wir wollen die Wettbewerbsbedingungen nicht einseitig für einige Länder verschlechtern und für Länder wie Österreich oder andere Transitländer verbessern.
But I believe that we should do all we can to keep the transport of dangerous goods to a minimum, in all countries, whether they are transit countries or not.	Aber ich glaube, daß wir alles unternehmen sollten, um den Transport gefährlicher Güter so gering wie möglich zu halten, und zwar in allen Ländern, ob Transitländer oder nicht.
Mr President, I would firstly like to congratulate the rapporteur, Mr Koch, on his magnificent work and his positive cooperation with the Commission with regard to improving the texts and presenting this report and this proposal; in the end there is only one amendment on the requirements for the aptitude examination for safety advisers in the transport of dangerous goods by road, rail or inland waterway.	Herr Präsident! In erster Linie möchte ich den Berichterstatter, Herrn Koch, zu seiner großartigen Arbeit und seiner konstruktiven Zusammenarbeit mit der Kommission bei der Verbesserung der Texte, der Vorlage dieses Berichts und dieses Vorschlags beglückwünschen; letztendlich gibt es nur einen Änderungsantrag in bezug auf die Anforderungen an die Prüfungsvorschriften für Sicherheitsberater für die Beförderung gefährlicher Güter auf Straße, Schiene oder Binnenwasserstraßen.
We understand that it is important that the two institutions - Parliament and Commission - cooperate and work together and that the current cooperation with the Committee on Regional Policy, and in particular the transport group, is magnificent.	Unserer Auffassung nach ist die Zusammenarbeit, die gemeinsame Arbeit der beiden Institutionen - Parlament und Kommission - wichtig, und die mit dem Ausschuß für Regionalpolitik bestehende Zusammenarbeit, konkret mit der Gruppe für Verkehr, ist hervorragend.
The common position includes practically all of the amendments accepted by the Commission and harmonises the minimum examination requirements for safety advisers and, at second reading, we can accept the amendment on the proposed date, which is much more realistic than the one originally suggested by the Commission, bearing in mind that we have now spent several years debating this question.	In den gemeinsamen Standpunkt wurden praktisch alle von der Kommission akzeptierten Änderungsanträge übernommen, die Mindestanforderungen an die Prüfungen für die Sicherheitsberater wurden harmonisiert, und in zweiter Lesung können wir den Änderungsantrag zum vorgeschlagenen Zeitpunkt annehmen, der viel realistischer ist als der anfangs von der Kommission vorgeschlagene, wenn man bedenkt, daß wir schon mehrere Jahre über diese Frage diskutieren.
Very briefly, I would like to thank the various Members for their interventions and to tell you that safety is one of the Commission' s priorities in the field of transport.	In ganz kurzen Worten möchte ich auch für die Beiträge der verschiedenen Abgeordneten danken und Ihnen, meine Damen und Herren, sagen, daß die Kommission der Sicherheit im Verkehrswesen Priorität einräumt.
As Mr Simpson has said very correctly, this is a process which we can never take for granted or regard as having come to an end.	Und wie Herr Simpson sehr richtig sagte, darf der Prozeß niemals als abgeschlossen, als gewonnen oder als vollendet betrachtet werden.
The process of increasing safety margins and safety guarantees in transport is a process which must be improved day by day.	Der Prozeß zur Erhöhung der Sicherheitsmargen und -garantien im Verkehrswesen ist ein Prozeß, der täglich vervollkommnet werden muß.
In this regard, I would also like to refer very briefly to the problems of the tunnels, which Messrs Rack and Swoboda have referred to, which, in the case of Austria, is doubtless a very sensitive issue, and great effort should be made to improve their safety.	In diesem Zusammenhang möchte ich auch ganz kurz auf die Probleme hinsichtlich der Tunnel eingehen, die von den Herren Rack und Swoboda angesprochen wurden und die im Falle Österreichs zweifellos ein sehr sensibles Thema sind, weshalb Anstrengungen unternommen werden müssen, um Möglichkeiten zur Erhöhung der Sicherheit zu finden.
In one of the worst accidents to have occurred recently, the goods being transported were not dangerous in themselves.	Bei einem der großen Unfälle in jüngster Zeit war nicht die Ladung an sich gefährlich.
Margarine and a few kilos of paint which, in principle, do not present risks, led to a genuine disaster.	Die Margarine und ein paar Kilo Farbe, die im Prinzip kein Risiko darstellten, verursachten eine echte Katastrophe.
Therefore, we will have to see how the requirements guaranteeing the maximum degree of safety can be further improved.	Deshalb muß geprüft werden, wie die Anforderungen zur Gewährleistung eines Maximums an Sicherheit noch optimiert werden können.
Finally, I would like to say that we have to consider safety in all types of transport.	Abschließend möchte ich sagen, daß es um die Sicherheit bei allen Transportarten geht.
This week we will be holding a debate here on the safety of sea transport, in light of the Erika disaster, and in the course of this year we will have to discuss our objectives in terms of the safety of air transport.	In dieser Woche werden wir hier aufgrund der Katastrophe der Erika eine Aussprache über die Sicherheit des Seeverkehrs führen, und wir müssen im Laufe dieses Jahres auch über die Sicherheitsziele im Luftverkehr diskutieren.
But I would like to say that safety is a priority objective for the Commission.	Ich will zum Ausdruck bringen, daß die Sicherheit ein vorrangiges Ziel der Kommission ist.
As I will say in the debate on the Erika disaster, we do not wait until there is a disaster to deal with the question of safety, but we work on it even when there are no such circumstances, which simply serve to demonstrate the urgency for an effective response to this type of problem.	Wie ich in der Aussprache über die Erika sagen werde, warten wir nicht auf eine Katastrophe, um uns mit dem Sicherheitsaspekt zu befassen, sondern wir arbeiten daran am Rande dieser Geschehnisse. Diese führen uns allerdings die Dringlichkeit einer effektiven Antwort auf Probleme dieser Art vor Augen.
I would like to repeat my appreciation to all the speakers and especially to the rapporteur, Mr Koch.	Ich möchte nochmals allen Rednern und ganz besonders dem Berichterstatter, Herrn Koch, meinen Dank sagen.
The debate is closed.	Die Aussprache ist geschlossen.
The vote will take place tomorrow at 12 p.m.	Die Abstimmung findet morgen um 12.00 Uhr statt.
Transport of dangerous goods by road	Gefahrguttransport auf der Straße
The next item is the report (A5-0104/1999) by Mr Koch, on behalf of the Committee on Regional Policy, Transport and Tourism, on the proposal for a European Parliament and Council directive amending Directive 94/55/EC on the approximation of the laws of the Member States with regard to the transport of dangerous goods by road [COM(1999) 158 - C5-0004/1999 - 1999/0083(COD)].	Nach der Tagesordnung folgt der Bericht (A5-0104/1999) von Herrn Koch im Namen des Ausschusses für Regionalpolitik, Verkehr und Fremdenverkehr für eine Richtlinie des Europäischen Parlament und des Rates (KOM(1999) 158 - C5-0004/1999 - 1999/0083(COD) ) zur Änderung der Richtlinie 94/55/EG zur Angleichung der Rechtsvorschriften der Mitgliedstaaten für den Gefahrguttransport auf der Straße.
Mr President, Commissioner, ladies and gentlemen, the directive on the approximation of the laws of the Member States with regard to the transport of dangerous goods by road, which entered into force on 1 January 1997, contains a number of transitional provisions which are only valid for a limited period of time, the term of validity being linked to the completion of specific standardisation work by the CEN, that is the European Committee for Standardisation.	Herr Präsident, verehrte Frau Kommissarin, liebe Kolleginnen und Kollegen! Die am 1. Januar 1997 in Kraft getretene Richtlinie zur Angleichung von Rechtsvorschriften der Mitgliedstaaten für Gefahrguttransporte auf der Straße beinhaltet einige Übergangsvorschriften, deren Gültigkeit befristet und an den Abschluß bestimmter Normungsarbeiten des CEN, also des Europäischen Komitees für Normung, gekoppelt ist.
Delays in the CEN' s work are now making it difficult to apply this very directive.	Aufgetretene Verzögerungen bei den Arbeiten des CEN führen nun zu Problemen bei der Anwendung eben dieser Richtlinie.
In particular, annexes cannot be adapted to take account of technical and industrial developments.	Insbesondere können Anhänge nicht entsprechend der technischen und industriellen Entwicklung angepaßt werden.
I regret this since we are having to take action because others have not done their job.	Ich bedauere dies, denn wir müssen tätig werden, weil andere ihre Arbeit nicht gemacht haben.
In this respect, I accept this proposal to amend Directive 94/55/EC which has been tabled for discussion today.	Insofern akzeptiere ich den vorliegenden und heute zur Diskussion stehenden Vorschlag zur Änderung der Richtlinie 94/55/EG.
Should the European Union fail to take action, then Member States would be obliged to amend their national legislation for a very brief period, until the CEN completes its work, which would cause unnecessary cost and uncertainty.	Ein Nichttätigwerden der Europäischen Union würde die Mitgliedstaten verpflichten, ihre innerstaatlichen Rechtsvorschriften für einen kurzen Zeitraum, nämlich bis zum Abschluß der Arbeiten des CEN, zu ändern, was unnötige Kosten und Verunsicherungen verursacht.
The amendment to the directive on today's agenda does not therefore affect the existing harmonisation of the transport of dangerous goods in the Community.	Die auf der heutigen Tagesordnung stehende Änderung der Richtlinie bewirkt also keine Änderung der in der Gemeinschaft bestehenden Harmonisierung der Gefahrguttransporte.
It merely prolongs transitional rules by postponing deadlines, deletes provisions which are no longer applicable, and lays down the procedures for a) carrying out the ad hoc transportation of dangerous goods and b) enacting less stringent national regulations, in particular for the transport of very small amounts of dangerous goods within strictly defined local areas.	Sie verlängert lediglich Übergangsregeln durch das Verschieben von Terminen, sie streicht nicht mehr zutreffende Bestimmungen, und sie regelt die Verfahren für a) Ad hoc-Beförderungen gefährlicher Güter sowie b) den Erlaß weniger strenger nationaler Vorschriften, insbesondere bei der Beförderung sehr geringer Gefahrgutmengen auf lokal streng begrenzten Gebieten.
The amendment to the directive is consequently in full accordance with the principle of subsidiarity; the Member States obtain more powers.	Somit liegt die Änderung der Richtlinie ganz im Sinne der Subsidiarität; die Mitgliedstaaten erhalten mehr Befugnisse.
The Commission decides whether the Member States may impose certain rules of their own.	Die EU-Kommission entscheidet, ob die Mitgliedstaaten bestimmte eigene Vorschriften erlassen können.
In so doing, it is supported by a committee of experts on the transport of dangerous goods under the regulatory procedure.	Sie wird dabei von einem Expertenausschuß für Gefahrguttransporte nach dem Regelungsverfahren unterstützt.
The procedures for the exercise of these implementing powers conferred on the Commission were laid down afresh in the Council Decision of June 1999.	Die Modalitäten für die Ausübung dieser der Kommission übertragenen Durchführungsbefugnisse wurden durch Ratsbeschluß vom Juni 1999 neu geregelt.
The proposal to be discussed today, to amend the directive on the transport of dangerous goods by road, dates from May 1999, however, and could not therefore take account of the latest comitology procedure.	Der heute zur Diskussion stehende Vorschlag für eine Änderung der Richtlinie betreffend Gefahrguttransporte auf der Straße stammt jedoch vom Mai 1999 und konnte somit das aktuelle Komitologieverfahren noch nicht berücksichtigen.
Two of the amendments tabled and adopted unanimously by the committee relate precisely to this amended comitology procedure.	Die eingereichten und vom Ausschuß einstimmig angenommenen Änderungsanträge beziehen sich in zwei Fällen auf eben dieses veränderte Komitologieverfahren.
We would like to ensure that there is a reference to this as early as the recitals and that the period within which the Council has to make a decision - which is not clearly worded - is set at a maximum of three months.	Wir möchten sicherstellen, daß hierauf bereits in den Erwägungsgründen hingewiesen wird und die uneindeutig formulierte Frist, innerhalb der der Rat eine Entscheidung treffen muß, auf maximal drei Monate fixiert wird.
In addition, the need for greater transparency has been pointed out.	Darüber hinaus wird auf die Notwendigkeit einer verstärkten Transparenz hingewiesen.
A further amendment allows the Member States to impose more stringent requirements, in particular for vacuum tanks, if work is done or goods are transported as a priority in temperatures well below -20ºC.	Ein weiterer Änderungsantrag erlaubt es den Mitgliedstaaten, schärfere Forderungen, insbesondere für Vakuumtanks, zu erlassen, wenn vorrangig bei Temperaturen weit unter minus 20º C gearbeitet bzw. transportiert wird.
This is in the special interest of northern European regions.	Dies liegt im besonderen Interesse nordeuropäischer Regionen.
A final amendment is intended to ensure that tanks and tankers put into service between 1 January 1997 and the entry into force of this directive may continue to be used provided that they have been constructed and maintained in accordance with it.	Ein letzter Änderungsantrag soll bewirken, daß die Nutzung der zwischen dem 1. Januar 1997 und dem Inkrafttreten dieser Richtlinie in Betrieb genommenen Tanks und Tankfahrzeuge auch weiterhin erlaubt ist, wenn sie entsprechend konstruiert und gewartet worden sind.
I do realise that this is only a small step towards increased transport safety, but I would ask you to endorse this report.	Gleichwohl wissend, daß dies nur ein kleiner Schritt zu mehr Verkehrssicherheit ist, bitte ich Sie um die Zustimmung zu diesem Bericht.
Mr President, colleagues, a happy new year and millennium to you all.	Herr Präsident! Sehr geehrte Kollegen!
I am speaking for the first time in this plenary part-session, so this is quite exciting for me, a little like first love, although that did last longer than two minutes.	Ich wünsche Ihnen ein gutes neues Jahr und Millennium. Ich spreche heute zum ersten Mal im Plenum und finde das ganz schön aufregend, ein wenig wie bei der ersten Liebe, nur daß die gewöhnlich länger als zwei Minuten dauert.
I would like to briefly comment on the Commission' s proposal to amend the directive on the transport of dangerous goods by road.	Ich möchte den Vorschlag der Kommission zur Änderung der Richtlinie über Gefahrguttransporte auf der Straße aus meiner Sicht kurz kommentieren.
It is good that this directive should be established now, as, otherwise, Member States would have to amend their national acts for a very short time, a period of transition, which would again mean unnecessary costs and which would once more increase concern with regard to EU bureaucracy.	Ich halte es für gut, diese Richtlinie jetzt zu erlassen, weil anderenfalls die Mitgliedstaaten ihre Rechtsvorschriften für einen sehr kurzen Zeitraum, eine Übergangsphase, ändern müßten, was einerseits unnötige Kosten verursachen und andererseits wieder einmal Verdruß bei den Bürgern über die Bürokratie der EU hervorrufen würde.
The Commission' s proposal, however, does not take account of all the facts, such as the cold climate that prevails in the northern regions.	In dem Vorschlag der Kommission werden jedoch nicht alle relevanten Fragen berücksichtigt, wie beispielsweise die kalten klimatischen Bedingungen in den nördlichen Regionen.
Consequently, I have tabled some amendments to Mr Koch' s intrinsically excellent report, which have been adopted by our committee.	Deshalb habe ich einige Änderungsanträge zu dem grundsätzlich ausgezeichneten Bericht von Herrn Koch eingebracht, die in unserem Ausschuß angenommen worden sind.
My amendments concern the frost-resistance ratings for tankers carrying these dangerous goods.	Meine Änderungsanträge betreffen die Frostbeständigkeit der Transportbehälter für Gefahrgut.
According to the Commission' s proposal -20ºC would have been sufficient.	Nach dem Vorschlag der Kommission wäre ein Grenzwert von -20 ºC ausreichend.
On the shores of the Mediterranean, it is hard to imagine that in Lapland temperatures can fall considerably lower than that.	Am Mittelmeer kann man sich schwer vorstellen, daß der Frost in Lappland erheblich niedrigere Temperaturen erreicht.
There is support for the EU in Lapland also, so let us remember them.	Auch in Lappland wird die EU befürwortet, so daß wir hier auch an die Menschen dort denken müssen.
I have thus proposed that the frost rating be lowered to -40ºC.	Deshalb habe ich vorgeschlagen, den Grenzwert für Frost auf -40 ºC herabzusetzen.
This would be necessary to keep safety standards at the level they were in northern regions previously.	Das wäre auch erforderlich, um das Sicherheitsniveau in den nördlichen Regionen beizubehalten.
I hope my proposal will be taken into consideration in tomorrow' s vote.	Ich hoffe, daß mein Vorschlag in der morgigen Abstimmung Berücksichtigung findet.
Mr President, with your permission I should like to begin by expressing my admiration for the way in which you executed the quick changeover of the chairmanship just now during the debate.	Herr Präsident, wenn Sie erlauben, möchte ich Ihnen erst einmal meinen Respekt dafür ausdrücken, wie Sie vorhin während der Debatte den fliegenden Wechsel im Vorsitz vollzogen haben.
I thought that it was quite superb.	Ich fand das ganz hervorragend.
On the subject at hand, I think that the people of Europe must be able to be confident that the goods - however dangerous they are - which are transported on Europe's roads, railways, and so on are as safe as possible.	Zum Thema: Ich denke, die Bürger Europas müssen sich darauf verlassen können, daß das, was auf Europas Straßen, Schienen usw. transportiert wird, wenn es denn auch noch gefährliche Güter sind, so sicher wie möglich ist.
This directive is a contribution to this.	Diese Richtlinie ist ein Beitrag dazu.
What we are doing today is essentially a nuisance.	Das, was wir heute machen, ist im Grunde genommen ein Ärgernis.
The rapporteur, Mr Koch, to whom we express our thanks for the work which he has done on this, has already pointed out that basically everything could have been somewhat more advanced had it not been for the inactivity on the part of the CEN, which has been very dilatory in drawing up and adapting the directive.	Der Berichterstatter Koch, dem wir unseren Dank für seine Arbeit, die er dabei geleistet hat, aussprechen, hat darauf hingewiesen, daß im Grunde genommen alles schon etwas weiter sein könnte, wenn es nicht dieses Versäumnis der CEN gäbe, die in der Erstellung und dem Angleichen der Richtlinie sehr säumig sind.
That is why we can only hope - and we should resolve all of this this week - that, in 2001, we will finally have Community regulations for the transport of dangerous goods by road so that we have a degree of legal certainty here and also so that our roads are a good deal safer.	Deswegen können wir nur hoffen - und wir sollten das in dieser Woche alles beschließen -, daß wir dann 2001 endlich gemeinschaftliche Regelungen für den Gefahrguttransport auf der Straße haben, so daß wir hier ein Stück Rechtssicherheit und auch ein Stück mehr Sicherheit auf unseren Straßen haben.
	Herr Präsident!
Mr President, the report we are discussing here does not, in itself, entail any major changes. Most of the proposed amendments are of a purely technical nature.	Der Bericht, den wir heute behandeln, hat im Grunde genommen keine großen Erneuerungen zur Folge, da die meisten Abänderungsanträge rein technischer Natur sind.
It is nonetheless worth emphasising that, each time we make this type of decision, it is good from a broad environmental perspective and it is beneficial because it creates better prior conditions for exploiting the possibilities of the internal market.	Es sollte jedoch unterstrichen werden, daß solche Beschlüsse stets einen positiven Beitrag zum Umweltschutz leisten und somit die Voraussetzungen für ein Funktionieren des Binnenmarktes verbessern.
Very large quantities of dangerous goods are transported around the EU, both on roads and railways and by sea.	In der EU werden große Mengen gefährlicher Güter auf der Straße, Schiene und Wasserstraße befördert, und dafür benötigen wir effektive Rechtsvorschriften.
This makes it necessary to have proper rules governing transport of this kind. In area after area, we are now obtaining common minimum regulations for the Member States.	Nun bekommen wir für alle möglichen Bereiche gemeinsame Mindestregelungen für die Mitgliedstaaten, was außerordentlich begrüßenswert ist.
This is extraordinarily positive, and there is cause to thank the rapporteur, Mr Koch, for the work he has put in on this issue.	Ich möchte daher dem Berichterstatter, Herrn Koch, für seine Arbeit zu dieser Frage danken.
This is also important where the prerequisites for the internal market are concerned.	Das ist auch für die Bedingungen des Binnenmarktes von Wichtigkeit.
If we are to get a common transport market genuinely up and running, it is important that we should not only have regulations but that these regulations should also, as far as possible, apply to every country.	Für einen wirklich funktionierenden gemeinsamen Verkehrsmarkt brauchen wir nicht nur Rechtsvorschriften schlechthin, sondern möglichst einheitliche Vorschriften.
I should like to conclude by commenting on a third matter which is also of significance, namely an amendment tabled by Member of Parliament, Mr Ari Vatanen.	Lassen Sie mich abschließend noch einen dritten Punkt kommentieren, den ich ebenfalls für sehr bedeutsam halte: den Abänderungsantrag des Abgeordneten Ari Vatanen.
In many ways, the prerequisites differ from one Member State to another.	Die Voraussetzungen in den einzelnen Mitgliedstaaten sind sehr verschieden.
By approving this amendment, we take account of the fact that it can be very cold in the northern parts of the European Union.	Durch die Annahme dieses Antrags tragen wir der Tatsache Rechnung, daß es in den nördlichen Teilen der Union sehr kalt werden kann.
This makes it necessary to also take account of the ways in which materials and packaging are affected by cold of this kind.	Die Auswirkungen dieser Kälte auf Material und Verpackung darf nicht außer acht gelassen werden.
It is good that, in establishing the present regulations, we can also be flexible. I hope that the Commission is able to accept the present amendment.	Herr Präsident, ich betrachte es als positiv, daß diese Regelung flexibel gestaltet werden kann und hoffe, die Kommission wird diese Änderung annehmen.
Mr President, I would like to thank not only Mr Koch, but also the Vice-President of the Commission for the clear and unambiguous way in which they have declared their support for safety in the transport sector and acknowledged it as a priority.	Herr Präsident, ich möchte nicht nur dem Kollegen Koch, sondern auch der Vizepräsidentin der Kommission dafür danken, daß sie sich so klar und eindeutig zur Sicherheit im Verkehrsbereich und zur Priorität der Sicherheit bekannt hat.
The reason Mr Koch produced his sound report was because the work in the CEN and within the United Nations Economic Commission was proceeding none too expeditiously.	Der Kollege Koch hat seinen guten Bericht gemacht, weil im CEN und auch im Rahmen der Wirtschaftskommission der Vereinten Nationen die Arbeit nicht so expeditiv gemacht wurde.
I would like to ask the Vice-President if she is in a position to tell us today what the state of play is with regard to the efforts towards harmonisation being made by these two organisations, and whether the EU is in a position to hasten these harmonisation efforts, in accordance with principles that are as simple as possible.	Ich möchte die Vizepräsidentin fragen, ob sie uns heute sagen kann, wie der Stand der Dinge bei den Harmonisierungsbestrebungen dieser beiden Organisationen ist, und ob die EU die Möglichkeit hat, die Harmonisierungsbestrebungen nach möglichst einfachen Prinzipien zu beschleunigen.
For one thing is clear: even if we come to an excellent arrangement within the European Union, traffic does not stop at our borders, it goes beyond them.	Denn es ist klar: Selbst wenn wir innerhalb der Europäischen Union eine tolle Regelung treffen, der Verkehr macht nicht Halt an diesen Grenzen, er geht darüber hinaus.
Hence there is certainly every reason to introduce more far-reaching regional provisions.	Daher sind weitergehende, nämlich regional weitergehende Regelungen sicherlich sinnvoll.
If the Commissioner is unable to do so today then would she be prepared to inform the committee in writing of how matters stand and what stage negotiations between the CEN and the Economic Commission are at?	Wenn die Frau Kommissarin das heute nicht machen kann, wäre sie dann bereit, dem Ausschuß schriftlich den Stand der Dinge und den Stand der Verhandlungen zwischen CEN und Wirtschaftskommission zu übermitteln?
Mr President, I would once again like to congratulate Mr Koch on his magnificent work on this other report, which in a way supplements the debate which we held in October on rail transport.	Herr Präsident! Ich möchte Herrn Koch noch einmal für seine Arbeit an diesem anderen Bericht gratulieren, der in gewisser Weise die Aussprache vom Oktober über den Schienenverkehr ergänzt.
We all regret that the European Committee for Standardisation (CEN) has not been able, in the required time, to carry out the amendment of the provisions necessary for the required harmonisation within the European Union.	Wir alle bedauern, daß das Europäische Komitee für Normung (CEN) nicht in der Lage gewesen ist, in der geforderten Zeit die notwendige Vorschriftenänderung für eine entsprechende Harmonisierung im Geltungsbereich der Europäischen Union durchzuführen.
This debate and the amendment of the directive currently in force allow us to incorporate differentiating elements which demonstrate the diversity of this Europe of ours.	Diese Aussprache und die Änderung der gegenwärtig geltenden Richtlinie ermöglichen uns die Berücksichtigung unterschiedlicher Gegebenheiten, die Ausdruck der Vielfalt unseres Europas sind.
A moment ago, Mr Vatanen spoke to us of lower temperatures, not of 20 degrees below zero, but of 40 degrees below zero.	Vor wenigen Augenblicken sprach Herr Vatanen von Temperaturen, die nicht nur unter 20 Grad minus, sondern unter 40 Grad minus liegen.
Of course, we accept that amendment - it is absolutely right - and I believe that we should incorporate specific circumstances which demonstrate the climatic diversity of the European Union, which sometimes take the form of specifics and of concrete requirements for the establishment of standards and characterisations of a technical nature.	Natürlich akzeptieren wir diesen Änderungsantrag, er ist völlig vernünftig, und ich glaube, es müssen konkrete Situationen in Betracht gezogen werden, die von der klimatischen Verschiedenartigkeit der Europäischen Union zeugen, die manchmal bei der Prüfung der Normungen und Charakterisierungen technischer Art in spezifische Festlegungen und konkrete Anforderungen umgesetzt werden.
I would like to say, with regard to Mr Swoboda' s comments on the activity of the CEN, that we are urging them to speed up their work as much as possible because it would be terrible if, despite the new deadline, we were to find ourselves after a year and a bit with the same difficulties because their work has not been concluded.	Zu den Worten von Herrn Swoboda über die Tätigkeit des CEN möchte ich sagen, daß wir sie drängen, ihre Arbeit maximal zu beschleunigen, denn es wäre dramatisch, wenn wir trotz der neuen Frist nach etwas mehr als einem Jahr vor den gleichen Schwierigkeiten stehen würden, weil die Arbeiten nicht zum Abschluß gebracht wurden.
Lastly, Mr President, the basic problems justifying this amendment of the directive have been pointed out. We have referred to the delay by the CEN, the amendment of certain provisions, the consistency between the text of the directive and the content of the annexes and the need to for it to be more specific.	Schließlich, Herr Präsident, sind bereits die Hauptprobleme dargelegt worden, die diese Änderung der Richtlinie rechtfertigen, wir sind auf die Verzögerung beim CEN, auf die Änderung einiger Vorschriften, auf die Übereinstimmung zwischen dem Wortlaut der Richtlinie und dem Inhalt der Anhänge sowie auf die Notwendigkeit einer stärkeren Präzisierung eingegangen.
The Commission accepts all of the contributions of the parliamentary committee and the rapporteur, Mr Koch, which are contained in the various amendments, specifically four.	Alle Beiträge des parlamentarischen Ausschusses und des Berichterstatters, Herrn Koch, die in verschiedenen, konkret in vier, Änderungsanträgen zum Ausdruck kommen, werden von der Kommission aufgegriffen.
We therefore accept the four amendments which have been proposed.	Wir akzeptieren also die uns unterbreiteten vier Änderungsanträge.
The debate is closed.	Die Aussprache ist geschlossen.
The vote will take place tomorrow at 12 p.m.	Die Abstimmung findet morgen um 12.00 Uhr statt.
Structural Funds - Cohesion Fund coordination	Koordinierung Strukturfonds/Kohäsionsfonds
The next item is the report (A5-0108/1999) by Mrs Schroedter, on behalf of the Committee on Regional Policy, Transport and Tourism, on the communication from the Commission in the field of the Structural Funds and their coordination with the Cohesion Fund: guidelines for programmes in the period 2000-2006 [COM(1999)344 - C5-0122/1999 - 1999/2127(COS)].	Nach der Tagesordnung folgt der Bericht (A5-0108/1999) von Frau Schroedter im Namen des Ausschusses für Regionalpolitik, Verkehr und Fremdenverkehr über die Mitteilung der Kommission: Die Strukturfonds und ihre Koordinierung mit dem Kohäsionsfonds - Leitlinien für die Programme des Zeitraums 2000-2006 (KOM(1999)344 - C5-0122/1999 - 1999/2127(COS)).
Mr President, it is particularly pleasing for me to make my first speech in the European Parliament on what is regarded as the most important issue within that part of the United Kingdom that I represent in this Parliament, namely Wales.	Herr Präsident, ich freue mich ganz besonders, daß mein erster Beitrag im Europäischen Parlament einem Thema gewidmet ist, das in dem Teil des Vereinigten Königreichs, den ich in diesem Parlament vertrete, nämlich Wales, als das wichtigste Thema überhaupt gilt.
A major part of Wales, as you know, has been granted Objective 1 status under the Structural Funds programme.	Wie Sie wissen, wurde einem beträchtlichen Teil von Wales gemäß Strukturfondsprogramm der Status einer Ziel-1-Region zuerkannt.
It is quite clear that many people within Wales are looking to the European Structural Funds programme to alleviate some of the great difficulties that we undoubtedly face.	Und so erwarten auch viele Menschen in Wales, daß die Europäischen Strukturfonds ihnen bei der Überwindung einiger der gewaltigen Schwierigkeiten, mit denen wir ohne Zweifel zu kämpfen haben, hilft.
We have seen poverty growing in Wales; and growing still further since 1997.	Die Armut in Wales nimmt weiter zu, wobei sie seit 1997 besonders stark ansteigt.
We have seen the gap between rich and poor widen.	Die Kluft zwischen Arm und Reich wird immer tiefer.
We are looking, therefore, within the Structural Funds programme not just to see industrial restructuring but also to see a wider improvement in the whole of the economic base within the Principality.	Wir erhoffen uns daher vom Strukturfondsprogramm nicht nur eine wirtschaftliche Umstrukturierung, sondern eine weitreichendere Verbesserung der wirtschaftlichen Basis des Landesteils.
What is, however, deeply damaging for us is the belief that in some way the granting of Structural Funds assistance is something that has been, in a sense, a success of the government.	Was uns jedoch schwer zu schaffen macht, ist die Tatsache, daß die Gewährung von Unterstützung im Rahmen der Strukturfonds in gewisser Weise als Erfolg der Regierung verbucht wird.
It is sadly only a recognition of the very great difficulties that Wales faces.	Dabei ist es doch nur ein weiterer Ausdruck für die immensen Schwierigkeiten, vor denen Wales steht.
That is why I want to highlight some of the issues that I believe the Commission must have at the forefront.	Deshalb möchte ich auf einige Probleme aufmerksam machen, denen sich die Kommission vorrangig widmen sollte.
We look to the Commission to deal with points in relation to additionality.	Wir erwarten von der Kommission, daß sie Problemen im Zusammenhang mit der Zusätzlichkeit mehr Aufmerksamkeit widmet.
We are dissatisfied with the fact that those figures seem to have been in some way hidden within UK figures.	Wir halten es für falsch, daß die entsprechenden Zahlen in gewisser Weise in den Zahlen für das Vereinigte Königreich untergegangen sind.
We look to the Commission also to ensure that there is matched funding for projects.	Wir erwarten von der Kommission, daß es einen ergänzenden Finanzierungsanteil für die Vorhaben gibt.
We look to it to challenge the UK Government, to ensure that the private sector, which surely must be providing the major impetus for Structural Funds expenditure, is involved in the planning stage.	Wir erwarten, daß sie die britische Regierung drängt sicherzustellen, daß der private Sektor, der zweifellos die treibende Kraft im Hinblick auf die Bereitstellung von Mitteln im Rahmen der Strukturfonds darstellen muß, in die Planung einbezogen wird.
Finally, we ask that the Commission ensures that Structural Fund monies are spent in a way which is transparent.	Schließlich bitten wir die Kommission, für mehr Transparenz bei der Ausgabe von Strukturfondsgeldern zu sorgen.
Too much of what takes place within this Parliament is not transparent.	Zu vielem, was in diesem Parlament passiert, mangelt es an Transparenz.
This is one area in which I believe the Commission can be a very great friend to Wales.	Dies ist ein Bereich, in dem sich die Kommission, wie ich meine, als wahrer Freund von Wales erweisen kann.
Mr President, our committee views these issues very differently and, to start, I will speak from the point of view of research.	Herr Präsident! Unser Ausschuß erörtert die vorliegenden Fragen aus vielen unterschiedlichen Blickwinkeln.
We see it as a very positive sign that, in her own conclusions, the rapporteur has taken account of our committee' s proposal that the Cohesion Fund countries should broaden the research infrastructure by locating universities and colleges in such a way that they would serve those who live in undeveloped regions better than now and make it easier for educated people to remain in their home districts.	Zunächst möchte ich mich zum Forschungsaspekt äußern. Wir erachten es als sehr positiv, daß die Berichterstatterin den Vorschlag unseres Ausschusses in ihre Schlußfolgerungen aufgenommen hat, wonach in den Kohäsionsländern die wissenschaftliche Infrastruktur ausgedehnt werden muß, indem Hochschulen und Bildungseinrichtungen an solchen Orten geschaffen werden, an denen sie besser als bisher den Bewohnern unterentwickelter Regionen zur Verfügung stehen, und es Absolventen erleichtert wird, in ihren Heimatregionen zu verbleiben.
This will be possible with action on the part of governments, and such decentralisation of higher education will be an unquestionably useful policy in evening out development.	Das wird durch staatliche Maßnahmen ermöglicht, und eine solche Dezentralisation der höheren Ausbildung ist nachgerade eine sinnvolle Politik für eine ausgeglichene Entwicklung.
Another matter we would like to address, specifically from the point of view of industrial policy, is that we would have liked the Commission to pay more attention to the effects of services, electronic commerce and the growing use of the Internet, when they were planning the coordination of Structural Funds and Cohesion Funds.	In einer anderen Frage, auf die wir besonders unter dem Blickwinkel der Industriepolitik aufmerksam machen möchten, hätten wir uns gewünscht, daß die Kommission bei der Planung der Koordinierung von Kohäsionsfonds und Strukturfonds die Auswirkungen des Wachstums des Dienstleistungssektors, des elektronischen Handels und der Nutzung des Internets mehr berücksichtigt hätte.
Poverty and wealth used to depend more on means of livelihood.	Armut und Reichtum hingen früher mehr von der Wirtschaftsstruktur ab.
The rich areas were those where there were jobs in industry, but today those areas might have become a burden, and they may well be poor, meaning we also have to invest in new sectors of industry such as electronic production, as I might call it, and the production of services, because they are the industries of the future.	Reich waren jene Regionen, in denen es Arbeitsplätze in der Industrie gab. Jetzt sind aus diesen Regionen teilweise Problemfälle und arme Gebiete geworden, wo auch in neue Branchen wie Elektronik und Dienstleistungen investiert werden muß, weil diese als zukunftsweisende Bereiche gelten.
In my opinion the committee drafting the report has not taken sufficient account of this, so on behalf of the Committee on Industry, External Trade, Research and Energy, I would draw the Commission' s attention to this issue.	Diese Tatsache hat der federführende Ausschuß meines Erachtens in seinem Bericht nicht ausreichend berücksichtigt, so daß ich die Kommission im Namen des Industrieausschusses darauf hinweisen möchte.
Finally, as the committee representing energy, we would have liked the issue of support for renewable energy resources from Cohesion and Regional Development funds to have been emphasised still more, thus, through a process of coordination, increasing the use of renewables so that the scant funding resources in the energy programme might have been compensated by means of these more substantial sums.	Als Ausschuß für Energie hätten wir uns schließlich noch gewünscht, daß die Förderung der erneuerbaren Energien aus den Mitteln des Kohäsions- und Strukturfonds eine noch größere Rolle gespielt hätte. Auf diese Weise hätte mittels Koordinierung die Nutzung dieser erneuerbaren Energieformen so entwickelt werden können, daß unzureichende Finanzmittel des Energieprogramms durch diese umfangreicheren Mittel kompensiert werden.
Mr President, I would very much like to thank Mrs Schroedter for the work she has done on this and to explain to colleagues that I am speaking for my colleague, Mrs Flautre, who followed this for the Committee on Employment and Social Affairs but who is unfortunately ill.	Herr Präsident, ich möchte Frau Schroedter ganz herzlich für die von ihr zu diesem Thema geleistete Arbeit danken. Gleichzeitig möchte ich erklären, daß ich im Namen meiner Kollegin Frau Flautre spreche, die die Stellungnahme im Auftrag des Ausschusses für Beschäftigung und soziale Angelegenheiten erarbeitet hat und leider erkrankt ist.
I would like to draw people's attention to Amendments Nos 1 and 2 which were agreed by the Committee on Employment and Social Affairs but not accepted by the Committee on Regional Policy, Transport and Tourism.	Ich möchte Ihre Aufmerksamkeit auf die Änderungsanträge 1 und 2 lenken, die vom Ausschuß für Beschäftigung und soziale Angelegenheiten vorgelegt, jedoch vom Ausschuß für Regionalpolitik, Verkehr und Fremdenverkehr abgelehnt wurden.
These amendments deal with the social economy and the need to provide social risk capital and support financially local schemes to develop employment opportunities and strengthen social cohesion.	Darin geht es um die Sozialwirtschaft und die Notwendigkeit der Bereitstellung von "social risk capital " und der finanziellen Unterstützung von lokalen Programmen zur Schaffung von Beschäftigungsmöglichkeiten und zur Stärkung des sozialen Zusammenhalts.
In the past, this Parliament has viewed the social economy as an important potential provider of employment.	Das Parlament sah in der Sozialwirtschaft stets einen wichtigen potentiellen Anbieter von Beschäftigungsmöglichkeiten.
These amendments also fit in with this Parliament's view that social exclusion is a serious issue needing constructive action.	Die genannten Änderungsanträge decken sich mit der vom Parlament vertretenen Ansicht, daß die soziale Ausgrenzung ein ernstes Problem darstellt, das konstruktive Maßnahmen erfordert.
We hope that those considering rejection of these amendments have very powerful reasons to offer to both Parliament and their citizens who are seeking employment.	Wir hoffen, daß diejenigen, die eine Ablehnung dieser Änderungsanträge in Betracht ziehen, sowohl dem Parlament als auch ihren Arbeit suchenden Bürgern triftige Gründe für ihre Entscheidung nennen können.
In her report, Mrs Flautre also drew attention to an area where coordination is sorely lacking, yet desperately needed.	Frau Flautre verwies in ihrem Bericht auch auf einen Bereich, dem es stark an Koordinierung mangelt, wenngleich gerade hier beträchtlicher Koordinierungsbedarf besteht.
The Commission proposals refer to the four pillars of employment strategy and the five fields of action of the European Social Fund.	Die Vorschläge der Kommission beziehen sich auf die vier Pfeiler der Beschäftigungsstrategie und die fünf Aktionsbereiche des Europäischen Sozialfonds.
But the lack of specific guidelines here is particularly to be regretted, as the idea of linking Social Fund assistance to the employment strategy will be put into effect for the first time during the 2000-2006 programme.	Doch das Fehlen konkreter Leitlinien ist um so bedauerlicher, als die Idee, die ESF-Interventionen mit der Beschäftigungsstrategie zu verknüpfen, im Planungszeitraum 2000-2006 erstmals umgesetzt wird.
It could be said that the omission gives the impression that the Commission too has no idea how to provide maximum coordination between European Social Fund assistance, which is subject to review after three and a half years, and the Member States' annual national plans for employment.	Dieses Versäumnis weckt jedenfalls den Eindruck, daß auch die Kommission nicht weiß, wie eine möglichst umfassende Koordinierung zwischen den ESF-Interventionen, die nach dreieinhalb Jahren einer Prüfung unterliegen, und den jährlichen Nationalen Aktionsplänen für die Beschäftigung der Mitgliedstaaten zu bewerkstelligen ist.
We hope that the Commission can reassure us that this was an oversight which is now being dealt with constructively.	Wir hoffen, daß uns die Kommission davon überzeugen kann, daß es sich dabei lediglich um ein Versehen handelt, das umgehend korrigiert wird.
Mr President, Commissioner, the proposal presented by the Commission, in accordance with its mandate, is a reasonable starting point for the Committee on Agriculture and Rural Development.	Herr Präsident, Herr Kommissar, meine Damen und Herren! Der von der Kommission in Erfüllung ihres Mandats unterbreitete Vorschlag ist für den Ausschuß für Landwirtschaft und ländliche Entwicklung ein vernünftiger Ausgangspunkt.
I would like to point out, however, that this starting point indicates to us the challenges which face us: maintaining a population in rural areas, given the changes taking place in all types of economic activity owing to agriculture' s increasing lack of importance amongst the various sources of income for rural society.	Ich möchte allerdings an dieser Stelle hervorheben, daß uns dieser Ausgangspunkt die vor uns stehenden Herausforderungen aufzeigt: angesichts der Veränderungen in den wirtschaftlichen Tätigkeiten aller Art infolge der schwindenden Bedeutung des Landwirtschaftssektors innerhalb der verschiedenen Einkommensquellen der ländlichen Gesellschaft die Bevölkerung im ländlichen Raum zu halten.
This, as well as the deficiencies in the networks of infrastructures and services and a generally very low level of employment, which furthermore is seasonal and lacks diversity, exacerbates the exodus from rural areas.	Zusammen mit den Unzulänglichkeiten in der Infrastruktur und im Dienstleistungsbereich und einem allgemein sehr spärlichen, stark saisonabhängigen und wenig diversifizierten Beschäftigungsangebot verstärken sie die Abwanderung aus den ländlichen Gebieten.
The consequences do not inspire hope.	Die Folgen lassen nicht auf sich warten.
It is the young people who are disappearing, who are getting an education and finding work outside of the rural areas, all of which has an unfavourable effect on those areas.	Es sind die jungen Menschen, die abwandern, diejenigen, die Ausbildung und Beschäftigung außerhalb der ländlichen Gebiete finden, was sich in diesen Regionen sehr ungünstig auswirkt.
This lack of infrastructure is also an obstacle to the establishment of companies and the creation of jobs.	Diese fehlende Infrastruktur ist wiederum ein Hindernis für die Ansiedlung von Unternehmen und die Schaffung von Arbeitsplätzen.
We have to remember that rural areas represent almost four fifths of the territory of the European Union.	Man muß sich vor Augen halten, daß der ländliche Raum nahezu vier Fünftel des Territoriums der Europäischen Union ausmacht.
Agriculture only provides 5.5% of employment in the Union.	Die Landwirtschaft stellt nur 5,5 % der Arbeitsplätze der Union.
Furthermore, three quarters of our farm workers are part-time and require supplements to their incomes.	Darüber hinaus sind drei Viertel unserer Landwirte Nebenerwerbslandwirte und auf zusätzliche Einkommensquellen angewiesen.
For this reason, one of the most important and essential objectives which we should set in the European Union is to make efforts to create new jobs in rural areas, outside of the agricultural sector, in sectors such as rural tourism, sport, culture, heritage conservation, the conversion of businesses, new technologies, services, etc. However, even though the role of agriculture is not exclusive, it is still essential, not only to prevent economic and social disintegration and the creation of ghost towns, but also because farmers play a fundamental role in managing the land, in preserving biodiversity and in protecting the environment.	Aus diesem Grund ist es eines der wichtigsten und weitreichendsten Ziele, die wir uns in der Europäischen Union stellen sollten, Anstrengungen zur Schaffung neuer Arbeitsplätze in den ländlichen Gebieten außerhalb des Agrarsektors zu unternehmen, unter anderem in den Bereichen ländlicher Tourismus, Sport, Kultur, Sanierung der Ressourcen, Umstellung von Unternehmen, neue Technologien, Dienstleistungen usw. Doch obwohl die Landwirtschaft keine ausschließliche Rolle mehr spielt, ist sie weiterhin wichtig, nicht nur, um den wirtschaftlichen und sozialen Niedergang der ländlichen Gebiete und das Entstehen von weiteren Geisterstädten zu verhindern, sondern auch, weil den Landwirten eine grundlegende Rolle bei der Bewirtschaftung des Territoriums, dem Erhalt der Artenvielfalt und dem Umweltschutz zukommt.
Therefore, we support the establishment of an agricultural and rural development policy which is consistent with the objectives we have set. We want rural areas, at the dawn of the 21st century, to be competitive and multi-functional, both with regard to agriculture and with regard to opening up to the diversity of non-agricultural activities.	Deshalb treten wir für eine Landwirtschaftspolitik und eine ländliche Entwicklung ein, die mit unseren Zielen im Einklang steht, sowie dafür, daß die ländlichen Gebiete an der Schwelle zum 21. Jahrhundert wettbewerbsfähig und multifunktional sein müssen, sowohl in bezug auf den landwirtschaftlichen Aspekt als auch hinsichtlich der Öffnung für die Vielfalt nicht landwirtschaftlicher Tätigkeiten.
It is important to prioritise general criteria for land planning and demographic equilibrium, and to bear in mind the conclusions of the Committee on Agriculture and Rural Development on the five fundamental issues, which have been only partly taken up by the Committee on Transport, Regional Policy and Tourism in its points 16 and 17.	Es ist wichtig, allgemeinen Kriterien der Raumordnung und der ausgewogenen Bevölkerungsstruktur vorrangige Beachtung zu schenken und die Schlußfolgerungen zu berücksichtigen, zu denen der Ausschuß für Landwirtschaft und ländliche Entwicklung in fünf Hauptaspekten gelangt ist, die nur teilweise vom Ausschuß für Regionalpolitik, Verkehr und Fremdenverkehr in seinen Punkten 16 und 17 aufgegriffen worden sind.
In conclusion, I would ask the Commission to take these five points into account when establishing the conclusions on the four pillars because I believe that, for the European Union, maintaining the population in rural areas must be one of the priority objectives.	Abschließend möchte ich die Kommission ersuchen, diese fünf Punkte bei der Formulierung der Schlußfolgerungen der vier Pfeiler zu berücksichtigen, denn nach meiner Auffassung muß die Bindung der Bevölkerung an den ländlichen Raum eines der vorrangigen Ziele der Europäischen Union bilden.
Mr President, Commissioner, I would like to begin by thanking Mrs Schroedter, the rapporteur, for her work.	Herr Präsident, Herr Kommissar, liebe Kolleginnen und Kollegen! Ich möchte meinen Redebeitrag mit einem Dank an Frau Schroedter, der Berichterstatterin, für die geleistete Arbeit einleiten.
I think that this work has been carried out extremely well.	Ich meine, es ist eine sehr gute Arbeit.
I would also like to thank her for her willingness to enter into dialogue with the other political groups when compromise formulas have needed to be reached in the face of this avalanche of amendments - and perhaps there are more of them than we expected - but which genuinely reflect the importance of the report we are now discussing.	Außerdem möchte ich ihr für ihre Bereitschaft zum Dialog mit den übrigen Fraktionen bei der Suche nach Kompromißformeln angesichts dieser Lawine von Änderungsanträgen danken; es waren vielleicht mehr als erwartet, aber sie tragen eigentlich der Bedeutung des hier behandelten Berichts Rechnung.
We feel that it is important that the Commission takes account of the conclusions adopted by this Parliament, at least in spirit, because at this stage, it might seem as though what we are doing here is a useless exercise, and nothing but hot air.	Für uns ist es wichtig, daß die in diesem Parlament gebilligten Schlußfolgerungen von der Kommission, zumindest ihrem Wesen nach, berücksichtigt werden, denn bei dem nunmehr erreichten Stand könnte es so aussehen, als gäben wir uns hier einer unnütze, rein rhetorischen Tätigkeit hin.
The truth of the matter though is that we believe - and this is also shown in the way the conclusions have been drafted - that the Commission must take account of what is adopted by this Parliament, particularly in the face of an interim revision of these directives.	Wir sind indes der Ansicht und das spiegelt sich auch wörtlich in den Schlußfolgerungen wider , daß die Kommission die Beschlüsse dieses Parlaments in Betracht ziehen muß, vor allem im Hinblick auf die Halbzeitbewertung dieser Leitlinien.
In our amendments, we have stated the importance of the necessary synergies being produced between the Structural Funds, the Cohesion Fund and Community initiatives, so that their application should be reflected, in the best and most profitable way, by the gradual elimination of disparities between regions and by the creation of jobs which are, when all is said and done, the two central purposes of the funds we are discussing.	In unseren Änderungsanträgen haben wir festgeschrieben, welche Bedeutung wir der Herausbildung der notwendigen Synergien zwischen den Strukturfonds, dem Kohäsionsfonds und den Gemeinschaftsinitiativen beimessen, so daß ihre Anwendung auf optimale und rentabelste Weise im zunehmenden Abbau der regionalen Ungleichheiten und in der Schaffung von Arbeitsplätzen ihren Niederschlag findet, die letztendlich die beiden Hauptziele der hier zur Debatte stehenden Fonds sind.
In order to achieve a more rapid and efficient boost for attaining these objectives, we think that those who generate employment, the real entrepreneurs and those who really guarantee new sources of employment, that is, businesspeople, must participate in this initiative.	Um der Erreichung dieser Ziele einen schnellen und wirksamen Impuls zu verleihen, halten wir es für notwendig, daß die Unternehmer, das heißt diejenigen, die Arbeitsplätze schaffen, die wirklichen Unternehmergeist zeigen und tatsächlich neue Beschäftigungsquellen garantieren, in diese Initiative eingebunden werden.
Small and medium-sized businesses, above all, need to take part in the distribution of these funds.	Vor allem die kleinen und mittleren Unternehmer müssen in die Verteilung dieser Fonds einbezogen werden.
If they do not, if businesspeople feel marginalised, if entrepreneurs cannot take part, not only in managing but also in receiving these funds, we will have missed an opportunity to attain our objectives more rapidly.	Wenn sich die Unternehmer dagegen an den Rand gedrängt fühlen, wenn sie nicht mitwirken können ich sage jetzt, nicht nur an der Verwaltung, sondern an der Entgegennahme dieser Fonds , werden wir eine Chance zur schnelleren Erreichung unserer Ziele verloren haben.
Also, in order to attain our objectives, to overcome the disparities between regions and to seek out sources of employment, it is crucial to give our complete support to new technologies, to transport and communications networks and to renewable energies.	Gleichfalls wichtig für das Erreichen unserer Ziele, für die Überwindung der regionalen Ungleichheiten und für die Erschließung von Arbeitsplätzen ist der entschlossene Einsatz für die neuen Technologien, für die Verkehrs- und Kommunikationsnetze und für die erneuerbaren Energien.
All of this must be done - I repeat - with the participation of private business, which, by uniting its efforts with those of public administrations, but complementing them, never obstructing or excluding them, will lead to the creation of wealth in society and of jobs.	Und dies alles - wohlgemerkt unter Mitwirkung der Privatwirtschaft, die ihre Anstrengungen mit denen der öffentlichen Verwaltungen vereint, damit sie sich ergänzen und sich zu keinem Zeitpunkt behindern oder ausschließen schafft gesellschaftlichen Reichtum und Arbeitsplätze.
Mr President, it is incumbent upon me to remind my colleague, Mr Evans, of why Wales actually achieved Objective 1 status.	Herr Präsident, ich halte es für meine Pflicht, meinen Kollegen Herrn Evans daran zu erinnern, weshalb Wales überhaupt zu einer Ziel-1-Region erklärt wurde.
It was because of the discredited policies of his own Conservative Party.	Das ist das Ergebnis der fragwürdigen Politik seiner Partei, der Konservativen.
Let me also remind him that when his party leader, Mr Hague, was Secretary of State for Wales, he broke every rule in the book on additionality which led to a stern letter from Commissioner Wulf-Mathies regarding regulatory requirements.	Vielleicht darf ich ihn auch daran erinnern, daß der Vorsitzende seiner Partei, Herr Hague, als er noch Minister für Wales war, sämtliche Regeln in bezug auf die Zusätzlichkeit verletzt hat, die man nur verletzen kann, und dafür von Kommissionsmitglied Wulf-Mathies schriftlich entschieden zur Ordnung gerufen wurde.
I can tell you that the British Government is aware of its regulatory requirements on Objective 1 additionality.	Ich kann Ihnen versichern, daß der britischen Regierung sehr wohl bekannt ist, daß für die Ziel-1-Regionen der Grundsatz der Zusätzlichkeit gilt.
I suggest Mr Evans goes back and reads the regulation.	Ich schlage vor, daß sich Herr Evans nochmals mit der entsprechenden Verordnung vertraut macht.
My Group has made extensive amendments to both reports up for debate today.	Meine Fraktion hat umfangreiche Änderungsvorschläge für beide heute zur Debatte stehenden Berichte erarbeitet.
I want to focus our minds on the essential role of the guidelines.	Ich meine, wir sollten uns auf die zentrale Rolle der Leitlinien konzentrieren.
The objective is to provide a framework and tool to support and enhance economic regeneration, to get the most effective use of resources in the widest partnership and to put these regions back on the road to recovery and sustainable development so that eventually they come off the regional life-support machine.	Es geht darum, einen Rahmen und ein Instrumentarium zu schaffen, um die wirtschaftliche Erneuerung zu unterstützen und zu fördern, um die Ressourcen möglichst effektiv und unter Einbeziehung möglichst vieler Partner zu nutzen und den betreffenden Regionen den Weg zum wirtschaftlichen Aufschwung und zur nachhaltigen Entwicklung zu ebnen, so daß diese schließlich vom Finanztropf genommen werden können.
It is important to identify the skills and potential of our regions in the hi-tech sector.	Wir müssen herausfinden, über welche Qualifikationen und Potentiale unsere Regionen im High-Tech-Sektor verfügen.
It is particularly important in the light of reports in the media that Europe is rapidly losing ground to the US in the hi-tech growth industries of the future.	Das ist angesichts von Medienberichten, denen zufolge Europa bei den zukunftsträchtigen High-Tech-Wachstumsbranchen gegenüber den USA immer mehr an Boden verliert, ganz besonders wichtig.
The operation of the previous round of programmes is also very instructive in telling us what guidelines should not be about.	Die Durchführung der letzten Programmrunde ist auch insofern sehr lehrreich, als daß sie verdeutlicht, worum es bei den Leitlinien nicht gehen sollte.
They should not be about creating additional layers of bureaucracy and red tape.	Es sollte nicht darum gehen, neue bürokratische Hindernisse zu errichten.
They should not be about shifting priorities and policies halfway through project development, resulting in inevitable delays and underspends, particularly in the light of the new budgetary requirement.	Es sollte nicht darum gehen, auf halbem Wege Änderungen an den Prioritäten und Politiken vorzunehmen, was zwangsläufig Verzögerungen und Nichtausschöpfung der Mittel zur Folge hat. Dies ist gerade im Hinblick auf die neuen Anforderungen an die Haushaltsdisziplin von Bedeutung.
The implementation and operation of the guidelines cannot be left to the personal interpretation of one or other desk officer, either in the Commission or in the civil service.	Die Umsetzung und Anwendung der Leitlinien kann nicht der persönlichen Auslegung durch diesen oder jenen Bediensteten in der Kommission oder im Staatsdienst überlassen werden.
There must be an internal coherence in the Commission directorate, while respecting the specific local and regional aspects of Commission programmes.	Innerhalb der zuständigen Direktion der Kommission ist für Einheitlichkeit zu sorgen, während gleichzeitig die spezifischen lokalen und regionalen Aspekte der Kommissionsprogramme zu berücksichtigen sind.
The conclusion is that we must make the case for guidelines to be broad, indicative and flexible to assist our programme managers and fund-users and to get the maximum potential out of our new fields of regeneration.	Daraus läßt sich ableiten, daß wir breite, indikative und flexible Leitlinien anstreben müssen, auf die sich sowohl unsere Programm-Manager als auch die Begünstigten stützen können und die zu einer maximalen Erschließung des Potentials der neuen Bereiche der wirtschaftlichen Erneuerung beitragen.
