Resumption of the session	Reprise de la session
I declare resumed the session of the European Parliament adjourned on Friday 17 December 1999, and I would like once again to wish you a happy new year in the hope that you enjoyed a pleasant festive period.	Je déclare reprise la session du Parlement européen qui avait été interrompue le vendredi 17 décembre dernier et je vous renouvelle tous mes vux en espérant que vous avez passé de bonnes vacances.
Although, as you will have seen, the dreaded 'millennium bug' failed to materialise, still the people in a number of countries suffered a series of natural disasters that truly were dreadful.	Comme vous avez pu le constater, le grand "bogue de l'an 2000" ne s'est pas produit. En revanche, les citoyens d'un certain nombre de nos pays ont été victimes de catastrophes naturelles qui ont vraiment été terribles.
You have requested a debate on this subject in the course of the next few days, during this part-session.	Vous avez souhaité un débat à ce sujet dans les prochains jours, au cours de cette période de session.
In the meantime, I should like to observe a minute' s silence, as a number of Members have requested, on behalf of all the victims concerned, particularly those of the terrible storms, in the various countries of the European Union.	En attendant, je souhaiterais, comme un certain nombre de collègues me l'ont demandé, que nous observions une minute de silence pour toutes les victimes, des tempêtes notamment, dans les différents pays de l'Union européenne qui ont été touchés.
Please rise, then, for this minute' s silence.	Je vous invite à vous lever pour cette minute de silence.
(The House rose and observed a minute' s silence)	(Le Parlement, debout, observe une minute de silence)
Madam President, on a point of order.	Madame la Présidente, c'est une motion de procédure.
You will be aware from the press and television that there have been a number of bomb explosions and killings in Sri Lanka.	Vous avez probablement appris par la presse et par la télévision que plusieurs attentats à la bombe et crimes ont été perpétrés au Sri Lanka.
One of the people assassinated very recently in Sri Lanka was Mr Kumar Ponnambalam, who had visited the European Parliament just a few months ago.	L'une des personnes qui vient d'être assassinée au Sri Lanka est M. Kumar Ponnambalam, qui avait rendu visite au Parlement européen il y a quelques mois à peine.
Would it be appropriate for you, Madam President, to write a letter to the Sri Lankan President expressing Parliament's regret at his and the other violent deaths in Sri Lanka and urging her to do everything she possibly can to seek a peaceful reconciliation to a very difficult situation?	Ne pensez-vous pas, Madame la Présidente, qu'il conviendrait d'écrire une lettre au président du Sri Lanka pour lui communiquer que le Parlement déplore les morts violentes, dont celle de M. Ponnambalam, et pour l'inviter instamment à faire tout ce qui est en son pouvoir pour chercher une réconciliation pacifique et mettre un terme à cette situation particulièrement difficile.
Yes, Mr Evans, I feel an initiative of the type you have just suggested would be entirely appropriate.	Oui, Monsieur Evans, je pense qu'une initiative dans le sens que vous venez de suggérer serait tout à fait appropriée.
If the House agrees, I shall do as Mr Evans has suggested.	Si l'Assemblée en est d'accord, je ferai comme M. Evans l'a suggéré.
Madam President, on a point of order.	Madame la Présidente, c'est une motion de procédure.
I would like your advice about Rule 143 concerning inadmissibility.	Je voudrais vous demander un conseil au sujet de l'article 143, qui concerne l'irrecevabilité.
My question relates to something that will come up on Thursday and which I will then raise again.	Ma question porte sur un sujet qui est à l'ordre du jour du jeudi et que je soulèverai donc une nouvelle fois.
The Cunha report on multiannual guidance programmes comes before Parliament on Thursday and contains a proposal in paragraph 6 that a form of quota penalties should be introduced for countries which fail to meet their fleet reduction targets annually.	Le paragraphe 6 du rapport Cunha sur les programmes d'orientation pluriannuels, qui sera soumis au Parlement ce jeudi, propose d'introduire des sanctions applicables aux pays qui ne respectent pas les objectifs annuels de réduction de leur flotte.
It says that this should be done despite the principle of relative stability.	Il précise que cela devrait être fait malgré le principe de stabilité relative.
I believe that the principle of relative stability is a fundamental legal principle of the common fisheries policy and a proposal to subvert it would be legally inadmissible.	À mon sens, le principe de stabilité relative est un principe juridique fondamental de la politique commune de la pêche et toute proposition le bouleversant serait juridiquement irrecevable.
I want to know whether one can raise an objection of that kind to what is merely a report, not a legislative proposal, and whether that is something I can competently do on Thursday.	Je voudrais savoir si l'on peut avancer une objection de ce type à ce qui n'est qu'un rapport, pas une proposition législative, et si je suis habilité à le faire ce jeudi.
That is precisely the time when you may, if you wish, raise this question, i.e. on Thursday prior to the start of the presentation of the report.	C'est exactement à ce moment-là que vous pourrez, en effet, si vous le souhaitez, soulever cette question, c'est-à-dire jeudi avant le début de la présentation du rapport.
Madam President, coinciding with this year' s first part-session of the European Parliament, a date has been set, unfortunately for next Thursday, in Texas in America, for the execution of a young 34 year-old man who has been sentenced to death. We shall call him Mr Hicks.	Madame la Présidente, alors que se déroule la première session de l'année du Parlement européen, l'exécution d'un condamné à mort au Texas aux États-Unis, un jeune homme de 34 ans appelé Hicks, a été fixée, malheureusement, à jeudi prochain.
At the request of a French Member, Mr Zimeray, a petition has already been presented, which many people signed, including myself.	À la demande d'un député français, Monsieur Zimeray, une pétition a déjà été introduite ; elle a récolté de nombreuses signatures dont la mienne.
However, I would ask you, in accordance with the line which is now constantly followed by the European Parliament and by the whole of the European Community, to make representations, using the weight of your prestigious office and the institution you represent, to the President and to the Governor of Texas, Mr Bush, who has the power to order a stay of execution and to reprieve the condemned person.	Cependant, je vous demande, conformément à l'orientation désormais constamment exprimée par le Parlement européen et toute la Communauté européenne, d'intervenir auprès du président et du gouverneur du Texas, Monsieur Bush, en faisant jouer le prestige de votre mandat et de l'Institution que vous représentez, car c'est Monsieur Bush qui a le pouvoir de suspendre la condamnation à mort et de gracier le condamné.
This is all in accordance with the principles that we have always upheld.	Et tout ceci dans le respect des principes que nous avons toujours soutenus.
Thank you, Mr Segni, I shall do so gladly.	Merci, Monsieur Segni, je le ferai bien volontiers.
Indeed, it is quite in keeping with the positions this House has always adopted.	C'est en effet tout à fait dans la ligne des positions que notre Parlement a toujours adoptées.
Madam President, I should like to draw your attention to a case in which this Parliament has consistently shown an interest.	Madame la Présidente, je voudrais attirer votre attention sur un cas dont s'est régulièrement occupé le Parlement.
It is the case of Alexander Nikitin.	Il s'agit du cas d'Alexandre Nikitin.
All of us here are pleased that the courts have acquitted him and made it clear that in Russia, too, access to environmental information is a constitutional right.	Nous nous réjouissons tous, dans cette enceinte, que le tribunal ait prononcé sa libération et ait clairement établi qu'en Russie aussi, l'accès aux informations environnementales était un droit constitutionnel.
Now, however, he is to go before the courts once more because the public prosecutor is appealing.	Cependant, il se fait qu'il semblerait être à nouveau mis en accusation, le ministère public ayant interjeté appel.
We know, and we have stated as much in very many resolutions indeed, including specifically during the last plenary part-session of last year, that this is not solely a legal case and that it is wrong for Alexander Nikitin to be accused of criminal activity and treason because of our involvement as the beneficiaries of his findings.	Nous savons, et nous l'avons d'ailleurs établi dans de très nombreuses résolutions - y compris lors de la dernière période de session de l'année dernière -, que ce cas n'est pas seulement de nature juridique et qu'il est faux d'accuser Alexandre Nikitin d'activité criminelle et de trahison car nous sommes concernés par ses résultats et nous en profitons.
These findings form the basis of the European programmes to protect the Barents Sea, and that is why I would ask you to examine a draft letter setting out the most important facts and to make Parliament's position, as expressed in the resolutions which it has adopted, clear as far as Russia is concerned.	Ces résultats forment la base des programmes européens de protection de la mer de Barents et c'est pourquoi je vous prie d'examiner un projet de lettre vous dépeignant les faits essentiels de cette affaire et de communiquer à la Russie la position qui découle des décisions du Parlement.
Yes, Mrs Schroedter, I shall be pleased to look into the facts of this case when I have received your letter.	Oui, Madame Schroedter, j'examinerai bien volontiers les faits relatifs à cette question lorsque j'aurai reçu votre lettre.
Madam President, I would firstly like to compliment you on the fact that you have kept your word and that, during this first part-session of the new year, the number of television channels in our offices has indeed increased considerably.	Madame la Présidente, je voudrais tout d'abord vous féliciter pour avoir tenu parole car en effet, en cette première période de session, en cette nouvelle année, le nombre de chaînes de télévision a réellement été augmenté de manière significative dans nos locaux.
But, Madam President, my personal request has not been met.	Toutefois, Madame la Présidente, ce que j'avais demandé n'a pas été réalisé.
Although there are now two Finnish channels and one Portuguese one, there is still no Dutch channel, which is what I had requested because Dutch people here like to be able to follow the news too when we are sent to this place of exile every month.	Il y a bien deux chaînes finnoises et une chaîne portugaise, mais il n'y a toujours aucune chaîne néerlandaise. Pourtant je vous avais demandé une chaîne néerlandaise, car les Néerlandais aussi désirent pouvoir suivre les actualités chaque mois lorsqu'ils sont envoyés en cette terre d'exil.
I would therefore once more ask you to ensure that we get a Dutch channel as well.	Je vous demande donc à nouveau de faire le nécessaire pour que nous puissions disposer d'une chaîne néerlandaise.
Mrs Plooij-van Gorsel, I can tell you that this matter is on the agenda for the Quaestors' meeting on Wednesday.	Madame Plooij-van Gorsel, je peux vous dire que cette question est à l'ordre du jour de la réunion des questeurs de mercredi.
It will, I hope, be examined in a positive light.	Elle sera, je l'espère, examinée dans un esprit positif.
Madam President, can you tell me why this Parliament does not adhere to the health and safety legislation that it actually passes?	Madame la Présidente, comment se fait-il que le Parlement ne se conforme pas à la réglementation en matière de santé et de sécurité qu'il vote ?
Why has no air quality test been done on this particular building since we were elected?	Comment se fait-il qu'aucun test de qualité de l'air n'ait été réalisé dans ce bâtiment depuis notre élection ?
Why has there been no Health and Safety Committee meeting since 1998?	Comment se fait-il que le comité de santé et d'hygiène ne se soit plus réuni depuis 1998 ?
Why has there been no fire drill, either in the Brussels Parliament buildings or the Strasbourg Parliament buildings?	Comment se fait-il que nous n'ayons jamais fait d'exercice d'évacuation dans les bâtiments du Parlement de Bruxelles et de Strasbourg ?
Why are there no fire instructions?	Comment se fait-il qu'il n'y ait pas de consignes en cas d'incendie ?
Why have the staircases not been improved since my accident?	Comment se fait-il que les escaliers n'aient pas été améliorés depuis mon accident ?
Why are no-smoking areas not enforced?	Comment se fait-il que l'on ne respecte pas les zones non fumeurs ?
It seems absolutely disgraceful that we pass legislation and do not adhere to it ourselves.	Nous votons des réglementations et nous ne nous y conformons même pas. C'est scandaleux.
Mrs Lynne, you are quite right and I shall check whether this has actually not been done.	Madame Lynne, vous avez parfaitement raison et je vais vérifier si tout cela n' a effectivement pas été fait.
I shall also refer the matter to the College of Quaestors, and I am certain that they will be keen to ensure that we comply with the regulations we ourselves vote on.	Je vais soumettre également le problème au Collège des questeurs et je suis certaine que nos questeurs auront à cur de faire en sorte que nous respections la réglementation qu' en effet nous votons.
Madam President, Mrs Díez González and I had tabled questions on certain opinions of the Vice-President, Mrs de Palacio, which appeared in a Spanish newspaper.	Madame la Présidente, Mme Díez González et moi-même avions présenté quelques questions sur certaines opinions exprimées par la vice-présidente, Mme de Palacio, et publiées dans un journal espagnol.
The competent services have not included them in the agenda on the grounds that they had been answered in a previous part-session.	Les services compétents ne les ont pas inclues à l'ordre du jour, avançant que des réponses avaient déjà été apportées lors d'une précédente session.
I would ask that they reconsider, since this is not the case.	Je demande que cette décision soit reconsidérée car ce n'est pas le cas.
The questions answered previously referred to Mrs de Palacio' s intervention, on another occasion, and not to these comments which appeared in the ABC newspaper on 18 November.	Les questions auxquelles on a répondu précédemment se rapportaient à l'intervention de Mme de Palacio dans un dossier précis, et non aux déclarations parues dans le journal ABC du 18 novembre dernier.
Mr Berenguer Fuster, we shall check all this.	Cher collègue nous allons vérifier tout cela.
I admit that, at present, the matter seems to be somewhat confused.	Je vous avouerai que, pour le moment, les choses me semblent un petit peu confuses.
We shall therefore look into it properly to ensure that everything is as it should be.	Donc, nous allons revoir cela très sérieusement pour que tout soit bien en ordre.
Madam President, I should like to know if there will be a clear message going out from Parliament this week about our discontent over today's decision refusing to renew the arms embargo on Indonesia, considering that the vast majority in this Parliament have endorsed the arms embargo in Indonesia in the past?	Madame la Présidente, je voudrais savoir si cette semaine, le Parlement va envoyer un message clair exprimant son mécontentement quant à la décision prise aujourd'hui de refuser de renouveler l'embargo sur les armes à destination de l'Indonésie, alors que par le passé, le Parlement a souscrit à une très large majorité à l'embargo sur les armes à destination de l'Indonésie.
Today's decision not to renew the embargo is extremely dangerous considering the situation there.	La décision d'aujourd'hui de ne pas renouveler l'embargo est extrêmement dangereuse, compte tenu de la situation sur place.
So Parliament should send a message, since that is the wish of the vast majority.	Le Parlement devrait dès lors envoyer un message en ce sens, étant donné qu'une grande majorité des députés le souhaite.
It is irresponsible of EU Member States to refuse to renew the embargo.	En refusant de prolonger l'embargo, les États membres font preuve d'irresponsabilité.
As people have said, the situation there is extremely volatile.	D'aucuns l'ont dit, la situation en Indonésie est extrêmement explosive.
There is, in fact, a risk of a military coup in the future.	Il y a en réalité un risque de coup d'État.
We do not know what is happening.	Nous ne savons pas ce qui se passe.
So why should EU arms producers profit at the expense of innocent people?	Pourquoi donc les producteurs d'armes de l'UE devraient-ils s'enrichir sur le dos de personnes innocentes ?
In any event, this question is not presently included among the requests for topical and urgent debate on Thursday.	En tout cas, cette question ne figure pas pour l' instant parmi les demandes d' urgence pour jeudi prochain.
Agenda	Ordre des travaux
The next item is the verification of the final version of the draft agenda as drawn up by the Conference of Presidents at its meeting of 13 January pursuant to Rule 110 of the Rules of Procedure.	L' ordre du jour appelle l' examen du projet définitif d' ordre du jour tel qu' il a été établi par la Conférence des présidents, le jeudi 13 janvier, conformément à l' article 110 du règlement.
No amendments have been proposed relating to Monday and Tuesday.	S' agissant de lundi et mardi, je n' ai pas de modifications.
Relating to Wednesday:	En ce qui concerne le mercredi :
The Group of the Party of European Socialists requests that a Commission statement be included on its strategic objectives for the next five years and on the administrative reform of the Commission.	Le groupe socialiste demande d' inclure une déclaration de la Commission sur ses objectifs stratégiques pour les cinq ans à venir, ainsi que sur la réforme administrative de la Commission.
I would like Mr Barón Crespo, who made the request, to speak to propose it. That is, if he so wishes, of course.	Je souhaiterais que M. Barón Crespo, auteur de la demande, intervienne pour la justifier, s' il le souhaite bien sûr.
Then we shall follow the usual procedure, hearing one speaker in favour and one against.	Puis , nous ferons comme d' habitude : nous entendrons un orateur pour et un orateur contre.
Madam President, the presentation of the Prodi Commission' s political programme for the whole legislature was initially a proposal by the Group of the Party of European Socialists which was unanimously approved by the Conference of Presidents in September and which was also explicitly accepted by President Prodi, who reiterated his commitment in his inaugural speech.	Madame la Présidente, la présentation du programme politique de la Commission Prodi pour l'ensemble de la législature était au départ une proposition du groupe du parti des socialistes européens qui a obtenu l'unanimité lors de la Conférence des présidents en septembre, mais aussi l'approbation explicite du président Prodi, qui a réitéré son engagement dans son discours d'investiture.
This commitment is important because the Commission is a body with a monopoly of initiative in accordance with the Treaties and, therefore, basically dictates this Parliament' s political and legislative activity for the next five years.	Cet engagement est important dans la mesure où la Commission est un organisme qui détient, conformément aux Traités, le monopole de l'initiative et qui, par conséquent, décide pour l'essentiel quelle sera l'activité politique et législative de ce Parlement au cours des cinq prochaines années.
I would also like to point out, Madam President, that this Parliament voted to express its confidence in President Prodi during the previous legislature. It did so again during this legislature, in July, and then, in September, it voted once more to approve the whole Commission.	Je vous rappelle en outre, Madame la Présidente, que ce Parlement a voté par deux fois la confiance au président Prodi lors de la précédente législature ; au cours de cette législature, il l'a de nouveau votée en juillet et, ensuite, avec l'entrée en fonction de la nouvelle Commission, il a redonné sa confiance en septembre à l'ensemble de la Commission.
There has therefore been enough time for the Commission to prepare its programme and for us to become familiar with it and explain it to our citizens.	Il s'est donc écoulé suffisamment de temps pour que la Commission prépare son programme et pour que nous puissions en prendre connaissance et l'expliquer aux citoyens.
To this end, I would like to remind you of the resolution of 15 September, which recommended that the proposal be presented as soon as possible.	En ce sens, je vous rappelle la résolution du 15 septembre, laquelle recommandait que la proposition soit présentée dans les plus brefs délais.
The events of last week - which originated outside the Conference of Presidents, that Conference being used simply to corroborate and ratify decisions taken elsewhere - present us with a dilemma. Either the Commission is not ready to present this programme, in which case it should clarify it.	Les événements qui se sont produits la semaine dernière ­ qui sont nés en marge de la Conférence des présidents et se servent d'elle dans le seul but de corroborer et de ratifier des décisions prises en dehors de celle-ci ­ créent un dilemme : ou bien la Commission n'est pas en mesure de présenter ce programme ; (dans ce cas, il conviendrait qu'elle tire les choses au clair.
According to its President, it is in a position to do so.	Aux dires de son Président, la Commission serait en mesure de le faire.
Given that the Commission is represented by Vice-President de Palacio, I believe that, before voting, it would help if the Commission could let us know how ready it is to present this programme, as agreed. Alternatively, Parliament is not ready to examine this programme, as some appear to be suggesting.	Étant donné que la Commission est représentée par la vice-présidente, Mme de Palacio, je crois qu'avant de voter, il serait bon de connaître la position de la Commission en ce qui concerne ses disponibilités pour présenter le programme, tel que cela avait été convenu) ou bien le Parlement n'est pas en mesure d'examiner ce programme, comme certains semblent le prétendre.
In my opinion, this second hypothesis would imply the failure of Parliament in its duty as a Parliament, as well as introducing an original thesis, an unknown method which consists of making political groups aware, in writing, of a speech concerning the Commission' s programme a week earlier - and not a day earlier, as had been agreed - bearing in mind that the legislative programme will be discussed in February, so we could forego the debate, since on the next day our citizens will hear about it in the press and on the Internet and Parliament will no longer have to worry about it.	À mon avis, cette deuxième hypothèse signifierait le rejet de nos responsabilités en tant que Parlement, outre l'introduction d'une thèse originale, d'une méthode inconnue qui consiste à communiquer aux groupes politiques le discours du programme de la Commission par écrit une semaine avant ­ et non le jour avant, comme il avait été convenu ­, en tenant compte du fait que le programme législatif serait discuté en février, de telle sorte que nous pourrions nous passer du débat, car le lendemain, la presse et Internet l'auraient porté à la connaissance de tous les citoyens et le Parlement n'aurait plus de raison de s'en occuper.
My Group believes that since a parliament is meant to listen, debate and reflect, there can be no justification whatsoever for this delay and we believe that, if the Commission is ready to do so, we still have time to re-establish the original agreement between Parliament and the Commission and proceed in a manner which fulfils our duty to our fellow citizens.	Mon groupe estimant qu'un Parlement est là pour écouter, pour débattre et pour réfléchir, nous pensons qu'aucune raison ne justifie cet ajournement et nous croyons que si la Commission est en mesure de le présenter, nous avons parfaitement le temps pour rétablir l'accord original entre le Parlement et la Commission et d'agir de manière responsable vis-à-vis de nos concitoyennes et concitoyens.
Therefore, the proposal of the Group of the Party of European Socialists, and which you have mentioned, is that the Prodi Commission present its legislative programme on Wednesday, including its proposed administrative reform, because, otherwise, we could find ourselves in a paradoxical situation: on the pretext that there is no text, on the one hand, the President of the Commission would be denied his right to speak in this Parliament and, on the other hand, there would be a debate on a reform when Parliament had no prior knowledge of the texts on which it is based.	Par conséquent, la proposition du groupe du parti des socialistes européens que vous avez mentionnée est de maintenir à mercredi la présentation du programme de législature de la Commission Prodi, en incluant également dans le programme le projet de réforme administrative car, si ce n'est pas fait, nous risquons de nous retrouver dans une position paradoxale : sous prétexte qu'il n'y a pas de texte, on refuse d'une part le droit du président de la Commission à s'exprimer dans ce Parlement et, d'autre part, la tenue d'un débat sur une réforme dont le Parlement ne connaît pas les textes.
Therefore, Madam President, I would ask you to request that the Commission express its opinion on this issue and that we then proceed to the vote.	Je vous prie dès lors, Madame la Présidente, de demander à la Commission de s'exprimer maintenant et que l'on procède ensuite au vote.
(Applause from the PSE Group)	(Applaudissements du groupe PSE)
Madam President, I would like to make it very clear that, above all, the Commission has absolute respect for the decisions of this Parliament and, amongst those, the decision establishing its agenda.	Madame la Présidente, avant toute chose, je voudrais qu'il soit bien clair que la Commission a le plus grand respect pour les décisions de ce Parlement et, notamment, pour celle qui concerne la fixation de l'ordre du jour.
We therefore respect whatever Parliament may decide.	Par conséquent, nous respectons les décisions que pourrait prendre le Parlement dans ce sens.
But I would also like to make it very clear that President Prodi made a commitment to this Parliament to introduce a new debate, as Mr Barón Crespo has reminded us, which would be in addition to the annual debate on the Commission' s legislative programme, on the broad areas of action for the next five years, that is to say, for this legislature.	Mais je voudrais également qu'il soit bien clair que le président Prodi s'est engagé avec le Parlement à instaurer un nouveau débat, comme l'a rappelé M. Barón, qui vient s'ajouter au débat annuel sur le programme législatif de la Commission, sur les grandes lignes d'action pour la prochaine période de cinq ans, c'est-à-dire pour cette législature.
Madam President, I would like to say that the agreement reached in September distinguished this debate from the annual presentation of the Commission' s legislative programme.	Je voudrais dire, Madame la Présidente, que, dans l'accord auquel on est parvenu au mois de septembre, ce débat diffère de la présentation annuelle du programme législatif de la Commission.
I would also like to say that the Commission is prepared and ready to hold this debate whenever it is convenient and that we were ready to do so this week as we had agreed originally, on the basis that it would be presented the day before in a speech to parliamentary groups.	J'ajouterais, Madame la Présidente, que, du côté de la Commission, nous sommes prêts et disposés à organiser ce débat quand cela vous conviendra, que nous étions prêts à le développer cette semaine, comme cela avait été décidé au départ, en se basant sur le fait qu'il était présenté la veille dans un discours aux groupes parlementaires.
Therefore, Madam President, I would like to repeat that the Commission has debated the action plan for the next five years and, when Parliament decides, - this week if that is the decision - we are prepared to come and explain the programme for the next five years and, next month, the programme for 2000, which is what we fully agreed upon.	Je voudrais donc répéter, Madame la Présidente, que, pour notre part, nous avons discuté du programme d'action pour les cinq prochaines années et que nous sommes prêts à venir présenter le programme pour les cinq prochaines années quand le Parlement le décidera ­ y compris cette semaine, si telle est sa décision ­ et le programme pour l'an 2000, le mois prochain, ce sur quoi nous nous étions parfaitement mis d'accord.
I propose that we vote on the request of the Group of the Party of European Socialists that the Commission statement on its strategic objectives should be reinstated.	Je propose que nous votions sur la demande du groupe socialiste visant à réinscrire la déclaration de la Commission sur ses objectifs stratégiques.
(Parliament rejected the request) President.	(Le Parlement rejette la demande) La Présidente.
Still on the subject of Wednesday' s sitting, I have another proposal regarding the oral question on capital tax.	Toujours au sujet de la journée du mercredi, j'ai une autre proposition concernant la question orale sur l'impôt sur le capital.
The PPE-DE Group is requesting that this item be taken off the agenda.	Le groupe PPE­DE demande de retirer ce point de l'ordre du jour.
Is there a member who wishes to speak on behalf of this Group to propose this?	Y a-t-il un collègue pour prendre la parole au nom du groupe et justifier cette demande ?
Madam President, I can hear a ripple of laughter from the Socialists. I was told that large sections of the Socialist Group were also keen to have this item taken off the agenda, because at the vote in the Conference of Presidents no vote was received from the working group of Members of the Socialist Group responsible for this matter.	Madame la Présidente, pour répondre aux rires que j'entends parmi les socialistes, on m'a dit que de larges pans du groupe socialiste aimeraient également supprimer ce point de l'ordre du jour car lors du scrutin au sein de la Conférence des présidents, les collègues responsables du groupe socialiste ne disposaient pas du vote du groupe de travail.
I do not know whether this information is correct, but the PPE-DE Group would, in any case, be grateful if this item were removed because Parliament has addressed this issue several times already.	Je ne sais si cette information est correcte mais quoi qu'il en soit, le groupe PPE-DE vous saurait gré de supprimer ce point de l'ordre du jour car le Parlement s'est en effet maintes fois saisi de cette question.
Decisions have also been adopted against a tax of this kind.	Des décisions existent qui s'opposent à une telle taxe.
That is why my Group moves that this item be taken off the agenda.	C'est pourquoi mon groupe demande que ce point soit retiré de l'ordre du jour.
Thank you, Mr Poettering.	Merci Monsieur Poettering.
We shall now hear Mr Wurtz speaking against this request.	Nous entendons à présent M. Wurtz, qui s' exprime contre cette demande.
Madam President, I would firstly like to point out Mr Poettering' s lack of logic.	Madame la Présidente, je voudrais d' abord souligner le manque de logique de M. Poettering.
He has just been preaching to the Group of the Party of European Socialists because they went back on a decision taken in a perfectly clear manner at the Conference of Presidents, and now he is doing just the same.	A l' instant, il vient de faire la leçon au groupe socialiste parce que celui-ci revient sur une décision qui a été prise de façon extrêmement nette en Conférence des présidents. Or, il fait la même chose.
We discussed that matter and we were unanimous, with the exception of the PPE and ELDR Groups. As my fellow chairmen will recall, I even mentioned that it was not a matter of knowing whether one was for or against the Tobin tax, but of whether one dared to hear what the Commission and the Council thought of it.	Nous avons discuté, nous étions unanimes sauf le groupe PPE et le groupe libéral et j' avais même fait remarquer, vous vous en souviendrez mes chers confrères présidents, que la question n' est pas de savoir si vous êtes pour ou contre la taxe Tobin, mais de savoir si vous osez entendre ce que la Commission et le Conseil en pensent.
It is not a lot to ask.	Ce n' est pas demander beaucoup.
I therefore repeat the proposal that this oral question to the Commission and the Council should be retained so that we can find out, once and for all, the positions of these two bodies regarding the proposal which is relatively modest but which would give a clear message to public opinion, particularly after the tide of feeling generated by the failure of the Seattle Conference.	Donc, je réitère la proposition de maintenir cette question orale à la Commission et au Conseil pour connaître une fois pour toutes la position de ces deux instances par rapport à cette proposition relativement modeste, mais qui donnerait un signal important à l' opinion, en particulier après l' émotion suscitée par l' échec de la conférence de Seattle.
We shall proceed to vote on the PPE-DE Group' s request that the oral question regarding the capital tax be withdrawn from the agenda.	Nous allons voter sur la demande du groupe PPE-DE visant à retirer la question orale concernant l' impôt sur le capital de l' ordre du jour.
(Parliament rejected the request, with 164 votes for, 166 votes against and 7 abstentions)	(Le Parlement rejette la demande avec 164 voix pour, 166 voix contre et 7 abstentions)
Madam President, I would like to thank Mr Poettering for advertising this debate.	Madame la Présidente, je voudrais remercier M. Poettering pour le coup de publicité qu' il vient de donner à ce débat.
Thank you very much.	Merci.
Madam President, has my vote been counted? I was unable to vote electronically, since I do not have a card.	Madame la Présidente, a-t-on comptabilisé mon vote, qui n'a pu être réalisé électroniquement parce que je n'ai pas ma carte ?
My vote was "in favour" .	J'ai voté "pour".
Indeed, if we add the two Members who have declared themselves, then the result of the vote would be ....	Effectivement, si on ajoute les deux collègues qui se sont manifestés, nous obtenons comme résultat....
Madam President, the Presidency has already declared the result of the vote.	Madame la Présidente, la présidence a proclamé le résultat du vote.
There is no room for amendments.	Les modifications n'ont pas lieu d'être.
Madam President, in the earlier vote - and I will abide by your ruling on this matter - on the question of the strategic plan of the Commission I indicated that I would like to speak in advance of the vote on behalf of my Group.	Madame la Présidente, lors du dernier vote ­ et je m'en remets à votre décision sur ce sujet - sur la question du plan stratégique de la Commission, j'ai signalé que je demandais la parole avant le vote au nom de mon groupe.
That did not happen.	Mais ma demande n'a pas été satisfaite.
I would appreciate it if, on the close of this item of business, I might be allowed to give an explanation of vote on behalf of my Group.	Je vous saurai gré, à l'issue de ce point de l'ordre du jour, de me permettre de fournir un explication de vote au nom de mon groupe.
This is an important matter.	C'est important.
It would be useful for the record of the House to state how people perceive what we have just done in the light of their own political analysis.	Il serait utile de consigner au procès-verbal du Parlement la manière dont les gens perçoivent ce que nous venons de faire, à la lumière de leur propre analyse politique.
Madam President, I do not wish to reopen the debate, but I had also asked for the floor, to comment on Mr Barón Crespo's motion.	Madame la Présidente, je ne veux pas relancer le débat mais j'avais également demandé la parole pour m'exprimer quant à la demande de M. Barón Crespo.
You did not call me either.	Moi non plus, vous ne m'avez pas donné la parole.
I regret this, but the vote has already been taken and the decision is made so let us leave the matter there.	Je le déplore mais le vote a été effectué, la décision est tombée et nous devrions donc en rester là.
I am terribly sorry, Mr Hänsch and Mr Cox. I did not see you asking to speak.	Je suis désolée, Monsieur Hänsch et Monsieur Cox, je n'avais pas vu que vous demandiez la parole.
Even so, I think the positions are quite clear and they shall be entered in the Minutes.	Cela étant, je crois que les positions sont bien claires et elles seront consignées au procès-verbal.
When we adopt the Minutes for today' s sitting tomorrow, then any Members who think the positions have not been explained clearly enough may ask for amendments.	Lorsque nous adopterons demain le procès-verbal de la séance d'aujourd'hui, les collègues qui estimeront que les positions n'ont pas été suffisamment bien expliquées pourront demander des modifications.
This seems to me to be a workable solution.	Il me semble que c'est une bonne formule.
Of course, the Minutes for tomorrow' s sitting will take into account any additional explanations.	Bien entendu, le procès-verbal de la réunion de demain tiendra compte de toutes les explications complémentaires.
I think this is a better solution than proceeding now to extremely time-consuming explanations of votes.	Je crois que c'est une meilleure formule que de procéder maintenant à des explications de vote qui nous entraîneraient très loin.
Mr Cox, Mr Hänsch, would this be acceptable to you?	Monsieur Cox, Monsieur Hänsch, est-ce que cela vous convient ?
Madam President, if the vote records correctly how my Group voted I shall not, and cannot, object to that.	Madame la Présidente, si le procès-verbal reflète correctement le vote de mon groupe, je n'ai et n'aurai aucune objection à formuler.
If your ruling is that I cannot give an explanation of vote, I accept that but with reservations.	Si votre décision est que je ne puis pas donner d'explication de vote, je l'accepte, mais avec certaines réserves.
We shall pay particular attention to the wording of the Minutes, as we always do, of course.	Nous ferons donc très attention à la rédaction du procès-verbal. Nous le faisons d'ailleurs toujours.
If they do not properly reflect the positions adopted, then we may correct them, if necessary.	S'il ne reflète pas bien les positions, nous pourrons éventuellement le corriger.
(The order of business was adopted thus amended)	(Le Parlement adopte l'ordre des travaux ainsi modifié)
Safety advisers for the transport of dangerous goods	Conseillers à la sécurité pour le transport de marchandises dangereuses
The next item is the report (A5-0105/1999) by Mr Koch, on behalf of the Committee on Regional Policy, Transport and Tourism, on the common position adopted by the Council with a view to adopting a European Parliament and Council directive on the harmonisation of examination requirements for safety advisers for the transport of dangerous goods by road, rail or inland waterways (C5-0208/1999 - 1998/0106(COD)).	L'ordre du jour appelle le rapport (A5-0105/1999) de M. Koch, au nom de la commission de la politique régionale, des transports et du tourisme, concernant la position commune arrêtée par le Conseil en vue de l'adoption de la directive du Parlement européen et du Conseil relative aux exigences minimales applicables à l'examen des conseillers à la sécurité pour le transport par route, par rail ou par voie navigable de marchandises dangereuses (C5-0208/1999 - 1998/0106(COD)).
Commissioner, Madam President, ladies and gentlemen, I can be quite frank in saying that I welcome the Council's common position on harmonising the training of safety advisers for the transport of dangerous goods by road, rail or inland waterway.	Chère Commissaire, chère Présidente, chers collègues, je me félicite sans la moindre réserve de la position commune adoptée par le Conseil en vue d'harmoniser la formation des conseillers à la sécurité pour le transport de marchandises dangereuses par route, le rail ou les voies navigables.
Firstly, we needed to take action on a formal level in order to meet the requirements of Directive 96/35/EC, which obliges the Member States to appoint safety advisers and to organise the training, instruction and examination of these people but does not explain this explicitly.	Premièrement, sur le plan formel, nous devions agir pour répondre aux exigences de la directive 96/35/CE qui engage les États membres à mettre en place des responsables du transport de marchandises dangereuses ou des conseillers à la sécurité ainsi qu'à organiser la formation et l'examen des ces personnes, sans l'exprimer de manière explicite.
Secondly, by adopting this directive we achieve a) an increase in safety when dangerous goods are both transported and transhipped; b) a reduction in distortions of competition resulting from wide variations in national training structures and training costs and c) equal opportunities for safety advisers on the European labour market.	Deuxièmement, par cette directive, nous visons a) à augmenter la sécurité tant en matière de transport que de transbordement de marchandises dangereuses ; b) à démanteler les distorsions de concurrence qui résultent des différences existant au niveau national en matière de structure et de coût de la formation et c) à engendrer l'égalité des chances entre les conseillers à la sécurité sur le marché européen de l'emploi.
Thirdly, this directive, as it currently stands in the common position, guarantees - in particular because it confines itself exclusively to minimum standards - a high degree of flexibility and modest regulation by the European Union; by adopting it we contribute to the Member States' bearing a high level of individual responsibility.	Troisièmement, avec cette directive, telle qu'elle se présente dans la position commune et, en particulier, compte tenu du fait qu'elle se limite exclusivement à des normes minimales, nous garantissons un haut degré de flexibilité et une faible réglementation en provenance de l'Union européenne et nous contribuons à grandement responsabiliser les États membres.
All of this is in accordance with the principle of subsidiarity and is therefore to be greatly welcomed.	Tout ceci doit être particulièrement salué en termes de subsidiarité.
Our amendments from the first reading have, I believe, been taken into account very satisfactorily.	J'estime que nos propositions d'amendement introduites en première lecture ont été prises en considération de manière satisfaisante.
They have either been accepted or transposed with no change in the substance, or they have been rejected because the corresponding European arrangements have not been included, for example a system of penalties for violations of the rules or a complex classification structure for related groups of questions.	Elles ont été reprises, transposées dans l'esprit convenu ou ont été supprimées car les réglementations européennes y afférentes n'avaient pas été adoptées, en ce qui concerne par exemple un système de sanctions en cas d'infraction ou l'élaboration complexe de questionnaires.
The one unanimously adopted amendment of the Committee on Regional Policy and Transport, which concerns the timetable for implementing the directive, is something which I would urge you to support.	Je vous demande d'approuver la proposition d'amendement adoptée à l'unanimité par la commission de la politique régionale, des transports et du tourisme et relative au calendrier de mise en uvre de la directive.
By not setting a specific date for the Member States to implement the directive and instead giving them a period of three months after its entry into force, we are introducing a flexibility clause which ensures that the directive will be implemented without delay.	En n'imposant aucune date spécifique de mise en uvre de la directive par les États membres mais en leur octroyant un délai de trois mois après l'entrée en vigueur de ladite directive, nous introduisons une clause de flexibilité qui nous prémunit de tout retard dans la mise en uvre.
I would urge you to endorse this.	Je vous demande votre approbation.
Madam President, we cannot and must not accept the fact that we hear ever more frequently of accidents causing major damage on our roads, but also on our railways and waterways, not solely but at least partly because those involved do not take the transport of dangerous goods seriously enough or because - as a result of ignorance or a lack of training on the part of the drivers or others responsible for the various vehicles - a minor accident has all too often become a major disaster.	Madame la Présidente, nous ne pouvons pas - nous n'avons pas le droit - de nous résigner à entendre parler de plus en plus souvent d'accidents qui provoquent, sur les routes, les voies ferrées et navigables, des dégâts importants également imputables au fait que les personnes concernées ne prennent pas assez au sérieux le transport de marchandises dangereuses ou que par ignorance ou par manque de formation du chauffeur ou de la personne responsable des divers moyens de transport, il arrive trop souvent qu'un accident bénin tourne à la catastrophe.
As an Austrian, I still have a vivid memory, as, I believe, we all do, of the catastrophe which cost so many human lives last year in the Tauern Tunnel, where subsequent work to rebuild the parts of the tunnel which had been destroyed in this fire continued for many months at huge expense.	En tant qu'Autrichien - mais je pense qu'il en est de même pour nous tous -, j'ai encore un souvenir vivace de la catastrophe qui, l'année dernière, a coûté de nombreuses vies dans le tunnel du Tauern et imposé par la suite, pendant de nombreux mois, des travaux de reconstruction des destructions provoquées par cet incendie, travaux dont l'impact financier a été gigantesque.
The renovation project, which lasted for months, cut off this important route between the north and south of Europe.	Cette rénovation, qui s'est étendue sur plusieurs mois, a coupé cette importante voie de communication entre le nord et le sud de l'Europe.
The traffic which had to be diverted because of this stretched the patience of many thousands of people in the EU to the limit.	Le trafic de détournement qui en a résulté a accablé des milliers de citoyens de l'UE jusqu'aux limites du supportable.
In fact, all hell broke loose in some municipalities in my province.	Dans certaines communes de mon pays, c'était vraiment l'enfer.
Prevention has to be our answer to disasters of this kind and this draft directive is an important step towards well-trained safety advisers being available, so that the right action is taken in good time.	Notre réponse à de telles catastrophes doit être la prévention et le projet de directive qui nous est soumis nous permet de créer une base importante en vue de disposer de responsables bien formés en matière de sécurité et, dans le même temps, de faire ce qui doit être fait.
All the same, we must not content ourselves with enacting European law to ensure greater safety.	Nous ne devrions vraiment pas nous contenter de faire évoluer le droit européen vers une plus grande sécurité.
We also need to follow this up and make sure that our rules are transposed by the Member States in good time and - even more importantly - we need to ensure that they are also applied afterwards.	Nous devons également veiller, de manière conséquente, à ce que les États membres respectent les délais de mise en uvre de nos projets et, chose plus importante encore, nous devons veiller à ce que par la suite, ces projets soient appliqués.
Please let this not be yet another sector where we subsequently have to lament the lack of enforcement.	Je vous en prie : que ce ne soit pas un domaine de plus dans lequel nous devrons ensuite déplorer le déficit de mise en uvre.
I should like to address one final point. We must not content ourselves with sealing another hole in the safety net and shutting our eyes to the fact that, where transport safety in Europe is concerned, there is still much more to be done.	Je voudrais encore aborder un dernier point : nous ne pouvons pas nous contenter de combler une des carences du réseau de sécurité et ignorer qu'en matière de sécurité des transports, il y a encore énormément à faire.
In this context, I should like to make a request and ask the Commissioner responsible, who is with us here today, to table an appropriate text as soon as possible with a view to continuing to make it safer for traffic to transit tunnels in the future, so that we in Europe do not have to experience any more such disasters on this scale.	À cet égard, j'invite et je prie la commissaire responsable, présente parmi nous, de nous présenter dès que possible un texte de nature à augmenter à l'avenir la sécurité dans les tunnels afin qu'en Europe, nous ne devions plus faire face à des catastrophes d'une telle ampleur.
Madam President, first of all I should like to thank Mr Koch for his report which has, at its heart, the issue of transport safety.	Madame la Présidente, je voudrais avant tout remercier M. Koch de son rapport dans la question de la sécurité des transports occupe une place centrale.
The report looks at the issue of harmonising the examination requirements for safety advisors working in the areas of transportation of dangerous goods by road, rail and inland waterway.	Il envisage l'harmonisation du niveau des exigences applicables à l'examen des conseillers à la sécurité pour le transport de marchandises dangereuses par route, par rail ou par voie navigable.
I congratulate him on his excellent report.	Je le félicite de son excellent rapport.
Transport safety has sadly been in the news recently: the Paddington rail crash in London, the terrible rail crash in Norway, the two aviation crashes involving EU citizens and the natural disaster involving the Erika off Brittany - all within the last four months - remind us that transport safety can never be taken for granted and that those charged with protecting the public must be highly motivated and highly qualified.	La sécurité des transports a malheureusement fait l'actualité ces derniers temps : l'accident ferroviaire de Paddington, à Londres, l'effroyable accident ferroviaire en Norvège, les deux accidents d'avion transportant des passagers de l'Union européenne et la catastrophe naturelle de l'Erika, au large de la Bretagne ­ ces événements s'étant tous produits au cours des quatre derniers mois ­ nous rappellent que nous ne pouvons croire que la sécurité des transports est garantie d'office et qu'il faut que les responsables de la protection de la population soient extrêmement motivés et qualifiés.
The rapporteur has pointed out to the House that in its common position the Council has accepted six of Parliament's ten amendments put forward at first reading and that the substance of Parliament's other amendments has been retained.	Le rapporteur a signalé au Parlement que la position commune du Conseil retient six des dix amendements au texte présentés par le Parlement en première lecture, ainsi que la teneur des autres amendements du Parlement.
My Group will therefore support the common position and looks forward to the enactment of the legislation which will provide us with yet another tool in our fight to make transport in the European Union as safe as possible.	En conséquence, mon groupe soutiendra la position commune et espère que la législation sera rapidement promulguée, qui nous fournira un outil de plus dans notre lutte pour que le transport au sein de l'Union atteigne le plus haut niveau de sécurité possible.
When it comes to safety my Group will always support any initiatives to improve transport safety.	Mon groupe soutiendra d'ailleurs toute initiative visant à améliorer la sécurité des transports.
We still have a lot of work to do in this area as recent events have proved.	Il nous reste encore beaucoup à faire en la matière, comme le montre l'actualité.
Madam President, I would like to make a few comments.	Madame la Présidente, je voudrais faire quelques remarques.
I would like, first of all, to thank the rapporteur for his exceptionally accurate and technical work on the report and, secondly, the Commission for the proposal it has submitted.	Je tiens d'abord à remercier le rapporteur pour son travail technique extrêmement précis dans ce dossier et ensuite la Commission pour la proposition qu'elle a formulée.
We are concerned here with the harmonisation of examination requirements but also, in fact, with minimum requirements.	Il s'agit de l'harmonisation des exigences des examens, mais également des exigences minimales.
This is a pity, in a sense.	Dans un certain sens, c'est dommage.
Needless to say, safety on roads, railways and inland waterways is of key importance and, given the international nature of these types of transport, training for safety advisors should also be harmonised, therefore, as well as the requirements of the new ADR, for example, which is under way.	L'importance de la sécurité sur la route, sur les rails ou sur les voies navigables est naturellement primordiale et en raison du caractère international de ces modes de transport, nous devons également harmoniser les formations des conseillers à la sécurité, ainsi que, notamment, les exigences du nouvel ADR qui devrait bientôt entrer en vigueur.
This is important, but so is enforcement and there are, of course, a number of reasons why we need to pay particular attention to this.	C'est important mais le respect de ces mesures l'est tout autant et il y a naturellement plusieurs raisons pour lesquelles nous devons y prêter une attention particulière.
Just think of the road accidents which have occurred over recent years, for example in Belgium, the Netherlands and a number of other countries where lorries carrying dangerous goods continued to drive in foggy conditions when really they should have pulled off the road instead.	Examinons les accidents de la route de ces dernières années. Par exemple en Belgique, aux Pays-Bas et dans certains autres pays par temps de brouillard, avec des camions transportant des produits dangereux, alors que dans ces conditions, ils auraient dû rester sur le bord de la route.
Or ships from Eastern Europe which moor adjacent to ships over here, with all the obvious risks that this entails.	Ou des bateliers et leurs navires d'Europe orientale qui amarrent leurs bateaux côte à côte, ce qui rend les situations dangereuses d'autant plus évidentes.
Furthermore, it has transpired that research in the ports in Belgium, Finland, but also in Japan has shown that 50% of containers with partially dangerous cargo are not delivered correctly for shipment.	En outre, une enquête menée dans des ports belges, finnois et japonais a révélé que 50 pour cent des conteneurs avec un chargement partiellement dangereux n'étaient pas correctement déchargés.
In short, the issue is an important one.	Bref, le sujet est très important.
If we look at the situation where safety advisers are concerned, in a number of countries it is compulsory to employ such safety advisers in companies as from 1 January of this year.	Si nous examinons la situation des conseillers à la sécurité, depuis le 1er janvier, dans certains pays, les entreprises doivent disposer d'un tel conseiller.
There will be major problems with enforcing this rule at present, especially with smaller companies, as these cannot afford safety advisors.	Le respect de ce principe pose d'importants problèmes actuellement, notamment pour les entreprises moins importantes qui ne peuvent se le permettre financièrement.
These smaller companies either dispose of their cargo or mix it with other cargo, which causes problems.	Elles vont soit se débarrasser de leur cargaison, soit elles vont la mélanger avec d'autres cargaisons, ce qui engendre une série de problèmes.
It is therefore also being requested that ISO 9002 certificates possibly include the finer details of these activities in the form of annual reports and company analyses.	Pour cette raison, on demande que ces activités soient développées sous la forme de rapports annuels, d'analyses d'entreprises et qu'elles soient éventuellement reprises dans des certificats ISO 9002.
The work is done. All that remains is the business of enforcement.	Le travail est fait, il s'agit encore d'en assurer le respect.
I would like to mention one final point.	Je me permets de soulever un dernier point.
With regard to enforcement, proper agreements must also be concluded with the Eastern European countries because they will not enter into treaties which deal with this matter until 1 July 2001, that is to say in eighteen months' time.	En ce qui concerne ce respect, il convient également de conclure des accords satisfaisants avec les pays d'Europe orientale car ce n'est que le 1er juillet 2001, dans un peu plus d'un an et demi, qu'ils adhéreront aux conventions en vigueur.
This gives them a competitive edge for the interim period.	Cela leur conférera un avantage concurrentiel temporaire.
This is not in itself anything dreadful, but we should prioritise particularly the safety aspects for goods transported by road, rail and inland waterways and incorporate these, as part of the acquis communautaire, as soon as possible and present them to the acceding states.	Ce n'est pas grave en soi, mais ce que nous devrions faire, c'est accorder la priorité aux aspects de la sécurité des marchandises transportées par route, par rail ou par voie navigable et présenter aussitôt que possible cette partie de l'acquis aux pays candidats.
Madam President, the importance of transport safety is highlighted on a regular basis in this Parliament and rightly so.	Madame la Présidente, dans ce Parlement, on attire régulièrement l'attention, à juste titre, sur l'importance de la sécurité dans les transports.
The ever increasing volume of goods passing through Europe entails all kinds of risks, known and unknown, for employees and the social environment.	Les quantités de plus en plus importantes de marchandises traversant l'Europe engendrent, sciemment ou non, toute une série de risques pour le personnel qui en a la charge et la société en général.
Those having to deal with these risks should therefore meet stringent requirements.	Par conséquent, ceux qui sont soumis à ces risques doivent satisfaire à des exigences strictes.
The relevant standards which have been laid down in another Directive, 95/35/EC, seem sufficiently adequate to advise people in a responsible manner on the organisation of the transport of dangerous goods.	Les normes imposées à cet effet dans une autre directive, 95/35/CE, semblent suffisamment adéquates pour informer les gens de manière responsable de l'organisation du transport de marchandises dangereuses.
I am very pleased that agreement has also been reached with the Council on minimum standards regarding examinations, although I would have preferred it if uniform, set standards and modules had been established, so that certificates would be of equal value internationally.	Je suis ravi qu'il y ait également un accord avec le Conseil concernant les normes minimales pour leurs examens, même si j'aurais préféré des normes fixes et uniformisées, afin d'avoir des diplômes et des examens internationaux identiques.
This, however, does not seem feasible.	Toutefois, cela ne paraît pas réalisable.
Finally, the amendment tabled by the rapporteur is perfectly logical and I can, therefore, give it my wholehearted support.	Pour conclure, l'amendement proposé par le rapporteur est on ne peut plus logique et je le soutiens avec joie.
Mr President, Commissioner, I should first like to congratulate Mr Koch on his reports which, though technical, are nonetheless of very great significance for safety.	Monsieur le Président, Madame la Commissaire, chers collègues, je voudrais tout d'abord féliciter notre collègue Koch pour ses rapports, qui pour être techniques, n'en sont pas moins d'une très grande importance pour la sécurité.
I should like to make just a few comments.	Je voudrais émettre quelques rares remarques.
Firstly, I should like to ask the Commissioner - and I am convinced that my request will fall on fertile ground - to ensure that more attention is paid to the issue of safety, be it on the roads, on the waterways or at sea.	Je voudrais tout d'abord demander à Mme la commissaire - et je suis convaincu que mon vu ne demeurera pas lettre morte - qu'on accorde une plus grande attention à la question de la sécurité, que ce soit sur la route, sur les voies navigables ou en mer.
Considering that it is only today that we are dealing with a Commission proposal first made on 19 March 1998, even though Parliament responded relatively quickly, this time lag is a little too long.	Lorsque je considère que la première proposition de la Commission a été déposée le 19 mars 1998 et que nous nous en occupons aujourd'hui - alors que le Parlement a réagi assez rapidement -, le délai est un peu trop long.
This is not just the fault of the Commission, but I believe that we need to take action more quickly so as to achieve harmonisation in this area as well.	La faute n'en revient certes pas à la seule Commission mais je pense que nous devons réagir plus vite pour parvenir à une harmonisation dans ce domaine aussi.
My second point has already been mentioned: it concerns the minimum standards.	Le deuxième point a déjà été évoqué : les normes minimales.
In principle, I believe that in many cases where transport is concerned we should be working towards increased flexibility and country-specific rules.	Fondamentalement, je suis d'avis que, dans de nombreux domaines touchant aux transports, nous devrions viser à une plus grande flexibilité et à des règlements pays par pays.
However, when it comes to safety, I am rather sceptical because safety in Sweden, for example, is in principle no different from safety in Germany, Italy or Austria.	Pour ce qui est de la sécurité, je suis cependant quelque peu sceptique parce que, sur le principe, la sécurité n'est pas différente en Suède, par exemple, de ce qu'elle est en Allemagne, en Italie ou en Autriche.
I can live with these minimum standards, but I would ask the Commission to monitor the situation very carefully.	Je peux m'accommoder de ces normes minimales mais je prie la Commission de suivre ce dossier avec une réelle attention.
Should flexibility of this kind result in there being inadequate rules in some countries then we should work towards greater harmonisation.	Si ce genre de flexibilité devait mener à l'apparition de règlements insatisfaisants dans certains pays, nous devrions opter pour une plus grande harmonisation.
My third point has also been mentioned already.	Le troisième point a lui aussi été déjà évoqué.
As you know, like Mr Rack, I come from a transit country, where this issue plays a particularly important role.	Comme M. Rack, je viens d'une région de transit dans laquelle cette question joue un rôle particulier.
We do not want to make the conditions of competition worse for some countries unilaterally and improve them for countries such as Austria or other transit countries.	Nous ne voulons pas une détérioration unilatérale des conditions de concurrence prévalant dans certains pays au profit de pays tels que l'Autriche ou d'autres régions de transit.
But I believe that we should do all we can to keep the transport of dangerous goods to a minimum, in all countries, whether they are transit countries or not.	Je pense toutefois que nous devrions tout faire pour limiter autant que possible le transport de marchandises dangereuses, et ce dans l'ensemble des pays, qu'ils soient des régions de transit ou non.
Mr President, I would firstly like to congratulate the rapporteur, Mr Koch, on his magnificent work and his positive cooperation with the Commission with regard to improving the texts and presenting this report and this proposal; in the end there is only one amendment on the requirements for the aptitude examination for safety advisers in the transport of dangerous goods by road, rail or inland waterway.	Monsieur le Président, je voudrais tout d'abord féliciter le rapporteur, M. Koch, de son magnifique travail et de sa collaboration positive avec la Commission pour améliorer les textes, présenter ce rapport et cette proposition ; en fin de compte, seul un amendement a été présenté, qui porte sur les exigences applicables à l'examen d'aptitude des conseillers à la sécurité pour le transport par route, par rail ou par voie navigable de marchandises dangereuses.
We understand that it is important that the two institutions - Parliament and Commission - cooperate and work together and that the current cooperation with the Committee on Regional Policy, and in particular the transport group, is magnificent.	Nous pensons que la collaboration, le travail commun de la part des deux institutions ­ Parlement et Commission ­ est importante et que la coopération qui existe avec la commission de la politique régionale, et concrètement avec le groupe des transports, est magnifique.
The common position includes practically all of the amendments accepted by the Commission and harmonises the minimum examination requirements for safety advisers and, at second reading, we can accept the amendment on the proposed date, which is much more realistic than the one originally suggested by the Commission, bearing in mind that we have now spent several years debating this question.	La position commune inclut pratiquement tous les amendements acceptés par la Commission, harmonise les exigences minimales applicables aux examens des conseillers à la sécurité et, en deuxième lecture, nous pouvons accepter la date proposée, bien plus réaliste que celle projetée au départ par la Commission, sachant que cela fait déjà plusieurs années que nous débattons cette question.
Very briefly, I would like to thank the various Members for their interventions and to tell you that safety is one of the Commission' s priorities in the field of transport.	Très brièvement, je voudrais également remercier les différents députés de leurs interventions et dire que la sécurité est une priorité de la Commission dans le domaine des transports.
As Mr Simpson has said very correctly, this is a process which we can never take for granted or regard as having come to an end.	Comme l'a très bien dit M. Simpson, il ne faut jamais considérer que le processus est acquis, qu'il a abouti.
The process of increasing safety margins and safety guarantees in transport is a process which must be improved day by day.	Le processus visant à augmenter les marges, les garanties de sécurité dans les transports est un processus qu'il convient d'améliorer jour après jour.
In this regard, I would also like to refer very briefly to the problems of the tunnels, which Messrs Rack and Swoboda have referred to, which, in the case of Austria, is doubtless a very sensitive issue, and great effort should be made to improve their safety.	En ce sens, je voudrais également aborder très brièvement les problèmes des tunnels, auxquels MM. Rack et Swoboda ont fait référence, et qui, dans le cas de l'Autriche, constituent sans aucun doute un sujet très sensible, raison pour laquelle il est nécessaire de faire des efforts pour voir comment accroître leur sécurité.
In one of the worst accidents to have occurred recently, the goods being transported were not dangerous in themselves.	Lors d'un des gros accidents survenus dernièrement, la marchandise transportée n'était pas dangereuse en soi.
Margarine and a few kilos of paint which, in principle, do not present risks, led to a genuine disaster.	La margarine et quelques kilos de peinture qui ne présentaient normalement pas de risques, ont provoqué une véritable catastrophe.
Therefore, we will have to see how the requirements guaranteeing the maximum degree of safety can be further improved.	Il faut dès lors étudier la manière dont on peut ajuster encore plus les exigences afin de garantir un maximum de sécurité.
Finally, I would like to say that we have to consider safety in all types of transport.	Pour terminer, je voudrais dire qu'il est nécessaire d'aborder la sécurité de tous les types de transport.
This week we will be holding a debate here on the safety of sea transport, in light of the Erika disaster, and in the course of this year we will have to discuss our objectives in terms of the safety of air transport.	Cette semaine, nous organiserons un débat ici pour parler de la sécurité du transport maritime, à la suite de la catastrophe de l'Erika, et nous devrons discuter tout au long de cette année des objectifs, en matière de sécurité, du transport aérien.
But I would like to say that safety is a priority objective for the Commission.	Mais je tiens à dire, Mesdames et Messieurs les Députés, que la sécurité est un objectif prioritaire de la Commission.
As I will say in the debate on the Erika disaster, we do not wait until there is a disaster to deal with the question of safety, but we work on it even when there are no such circumstances, which simply serve to demonstrate the urgency for an effective response to this type of problem.	Comme je le dirai lors du débat sur l'Erika, nous n'attendons pas qu'une catastrophe survienne pour nous consacrer corps et âme à l'aspect de la sécurité, mais nous travaillons dessus en marge de ces circonstances, qui ne font que mettre en évidence l'urgence d'une réponse efficace à ce type de problèmes.
I would like to repeat my appreciation to all the speakers and especially to the rapporteur, Mr Koch.	Je tiens à réitérer mes remerciements à tous les intervenants et plus particulièrement au rapporteur, M. Koch.
The debate is closed.	Le débat est clos.
The vote will take place tomorrow at 12 p.m.	Le vote aura lieu demain à 12 heures.
Transport of dangerous goods by road	Transport de marchandises dangereuses par route
The next item is the report (A5-0104/1999) by Mr Koch, on behalf of the Committee on Regional Policy, Transport and Tourism, on the proposal for a European Parliament and Council directive amending Directive 94/55/EC on the approximation of the laws of the Member States with regard to the transport of dangerous goods by road [COM(1999) 158 - C5-0004/1999 - 1999/0083(COD)].	L'ordre du jour appelle le rapport (A5-0104/1999) de M. Koch, au nom de la commission de la politique régionale, des transports et du tourisme, sur la proposition de directive du Parlement européen et du Conseil modifiant la directive 94/55/CE relative au rapprochement des législations des États membres concernant le transport de marchandises dangereuses par route (COM(1999) 158 - C5-0004/1999 - 1999/0083 (COD)).
Mr President, Commissioner, ladies and gentlemen, the directive on the approximation of the laws of the Member States with regard to the transport of dangerous goods by road, which entered into force on 1 January 1997, contains a number of transitional provisions which are only valid for a limited period of time, the term of validity being linked to the completion of specific standardisation work by the CEN, that is the European Committee for Standardisation.	Monsieur le Président, Madame la Commissaire, chers collègues, la directive entrée en vigueur au 1er janvier 1997 et visant au rapprochement des législations des États membres concernant le transport de marchandises dangereuses par route contient quelques dispositions transitoires dont la validité est limitée dans le temps et liée à la conclusion des travaux du CEN, le Comité européen de normalisation.
Delays in the CEN' s work are now making it difficult to apply this very directive.	Les retards survenus dans les travaux du CEN entraînent à présent des problèmes dans l'application même de la directive.
In particular, annexes cannot be adapted to take account of technical and industrial developments.	Il s'agit en particulier des annexes qui ne pourront être adaptées pour répondre à l'évolution technique et industrielle.
I regret this since we are having to take action because others have not done their job.	Je le déplore car nous devons agir du fait que d'autres n'ont pas fait leur travail.
In this respect, I accept this proposal to amend Directive 94/55/EC which has been tabled for discussion today.	Dans cette mesure, j'accepte donc la proposition de modification de la directive 94/55/CE qui est soumise à notre examen.
Should the European Union fail to take action, then Member States would be obliged to amend their national legislation for a very brief period, until the CEN completes its work, which would cause unnecessary cost and uncertainty.	L'inaction de l'Union européenne obligerait les États membres à modifier leurs dispositions légales en la matière pour un bref laps de temps, à savoir jusqu'à la conclusion des travaux du CEN, ce qui entraînerait des coûts et des incertitudes inutiles.
The amendment to the directive on today's agenda does not therefore affect the existing harmonisation of the transport of dangerous goods in the Community.	La modification qui est à l'ordre du jour n'entraîne donc aucune modification de l'harmonisation communautaire existante en matière de transports de marchandises dangereuses.
It merely prolongs transitional rules by postponing deadlines, deletes provisions which are no longer applicable, and lays down the procedures for a) carrying out the ad hoc transportation of dangerous goods and b) enacting less stringent national regulations, in particular for the transport of very small amounts of dangerous goods within strictly defined local areas.	Elle ne fait que prolonger les réglementations transitoires en repoussant les délais, supprime des dispositions qui ont cessé d'être pertinentes et règle les procédures pour ce qui est a) des transports ad hoc de marchandises dangereuses et b) de la promulgation de dispositions nationales moins strictes, en particulier pour le transport de quantités très réduites de marchandises dangereuses dans des zones strictement délimitées.
The amendment to the directive is consequently in full accordance with the principle of subsidiarity; the Member States obtain more powers.	Ce faisant, la modification de la directive s'inscrit pleinement dans l'esprit de subsidiarité ; les États membres bénéficiant de compétences accrues.
The Commission decides whether the Member States may impose certain rules of their own. In so doing, it is supported by a committee of experts on the transport of dangerous goods under the regulatory procedure.	La Commission européenne décide si les États membres peuvent édicter des dispositions spécifiques déterminées, la procédure de réglementation prévoyant qu'elle bénéficie à cette fin du soutien d'un comité d'experts en matière de transports de marchandises dangereuses.
The procedures for the exercise of these implementing powers conferred on the Commission were laid down afresh in the Council Decision of June 1999.	En juin 1999, une décision du Conseil a redéfini les modalités de l'exercice des compétences d'exécution conférées à la Commission.
The proposal to be discussed today, to amend the directive on the transport of dangerous goods by road, dates from May 1999, however, and could not therefore take account of the latest comitology procedure.	Toutefois, la présente proposition de directive modifiant la directive en matière de transport de marchandises dangereuses par route remonte à mai 1999 et ne pouvait donc tenir compte de la procédure comitologique actuelle.
Two of the amendments tabled and adopted unanimously by the committee relate precisely to this amended comitology procedure.	Sur deux cas précis, les propositions d'amendement introduites par la commission et y ayant fait l'objet d'un accord unanime portent justement sur cette procédure comitologique modifiée.
We would like to ensure that there is a reference to this as early as the recitals and that the period within which the Council has to make a decision - which is not clearly worded - is set at a maximum of three months.	Nous voudrions être sûrs que cela soit déjà signalé dans les considérants et que le délai clairement formulé dans lequel le Conseil doit prendre une décision soit fixé à un maximum de trois mois.
In addition, the need for greater transparency has been pointed out.	On insiste en outre sur la nécessité d'une transparence accrue.
A further amendment allows the Member States to impose more stringent requirements, in particular for vacuum tanks, if work is done or goods are transported as a priority in temperatures well below -20ºC. This is in the special interest of northern European regions.	Une autre proposition d'amendement permet en outre aux États membres au sein desquels le travail et le transport se déroulent régulièrement sous des températures nettement inférieures à -20ºC d'édicter des exigences plus strictes, en particulier pour ce qui concerne les citernes, ceci dans l'intérêt tout particulier des régions nordiques de l'Europe.
A final amendment is intended to ensure that tanks and tankers put into service between 1 January 1997 and the entry into force of this directive may continue to be used provided that they have been constructed and maintained in accordance with it.	Enfin, une dernière proposition d'amendement devrait permettre de continuer d'utiliser les citernes et véhicules mis en service entre le 1er janvier 1997 et l'entrée en vigueur de cette directive si leur construction et leur entretien répondent aux exigences.
I do realise that this is only a small step towards increased transport safety, but I would ask you to endorse this report.	Tout en sachant que ce n'est là qu'un petit pas vers une plus grande sécurité en matière de transport, je vous prie d'approuver ce rapport.
Mr President, colleagues, a happy new year and millennium to you all.	Monsieur le Président, chers collègues, je vous adresse tous mes vux pour la nouvelle année et le nouveau millénaire.
I am speaking for the first time in this plenary part-session, so this is quite exciting for me, a little like first love, although that did last longer than two minutes.	C' est la première fois que je prends la parole en plénière, il y a donc de quoi être un peu nerveux, un peu comme avec le premier amour, mais le premier amour a quand même duré heureusement plus de deux minutes.
I would like to briefly comment on the Commission' s proposal to amend the directive on the transport of dangerous goods by road.	Je voudrais commenter brièvement la proposition de la Commission modifiant la directive sur le transport de marchandises dangereuses par route.
It is good that this directive should be established now, as, otherwise, Member States would have to amend their national acts for a very short time, a period of transition, which would again mean unnecessary costs and which would once more increase concern with regard to EU bureaucracy.	C' est une bonne chose que cette directive soit arrêtée maintenant, car sinon les États membres seraient obligés de modifier leur législation nationale pour une période transitoire très courte, ce qui ne ferait qu' entraîner des coûts inutiles et augmenterait encore une fois le mécontentement des gens face à la bureaucratie communautaire.
The Commission' s proposal, however, does not take account of all the facts, such as the cold climate that prevails in the northern regions.	La proposition de la Commission ne prend cependant pas en considération tous les facteurs nécessaires. Je pense par exemple au climat froid des régions septentrionales.
Consequently, I have tabled some amendments to Mr Koch' s intrinsically excellent report, which have been adopted by our committee.	Aussi ai-je proposé quelques amendements au rapport, excellent en soi, de M. Koch, amendements qui ont été adoptés par notre commission.
My amendments concern the frost-resistance ratings for tankers carrying these dangerous goods.	Mes amendements concernent la résistance au froid des citernes de transport des substances dangereuses.
According to the Commission' s proposal -20ºC would have been sufficient. On the shores of the Mediterranean, it is hard to imagine that in Lapland temperatures can fall considerably lower than that.	D' après la proposition de la Commission, une limite de ­20º aurait été suffisante ; il est difficile de s' imaginer, quand on est bord de la Méditerranée, qu' en Laponie la température descend nettement en dessous de cette limite.
There is support for the EU in Lapland also, so let us remember them.	En Laponie aussi, les gens sont favorables à l' Union européenne, pensons donc à eux.
I have thus proposed that the frost rating be lowered to -40ºC.	C' est pourquoi j' ai proposé que la limite soit abaissée à -40º.
This would be necessary to keep safety standards at the level they were in northern regions previously.	Cette mesure serait réellement nécessaire pour maintenir à son niveau la sécurité des transports dans les régions septentrionales.
I hope my proposal will be taken into consideration in tomorrow' s vote.	J' espère que ma proposition sera prise en considération lors du vote de demain.
Mr President, with your permission I should like to begin by expressing my admiration for the way in which you executed the quick changeover of the chairmanship just now during the debate.	Monsieur le Président, si vous le permettez, je voudrais tout d'abord vous féliciter de la diligence dont vous avez témoigné en reprenant au vol la présidence au cours de ce débat.
I thought that it was quite superb.	J'ai trouvé cela tout à fait exceptionnel.
On the subject at hand, I think that the people of Europe must be able to be confident that the goods - however dangerous they are - which are transported on Europe's roads, railways, and so on are as safe as possible.	Pour ce qui est du thème proprement dit, je pense que les citoyens d'Europe doivent pouvoir compter sur le fait que les marchandises transportées sur les routes, les voies ferrées et autres voies de transport européennes, qu'il s'agisse ou non de marchandises dangereuses, sont transportées d'une manière aussi sûre que possible.
This directive is a contribution to this.	Cette directive y contribue.
What we are doing today is essentially a nuisance.	Dans le fond, ce que nous faisons est contrariant.
The rapporteur, Mr Koch, to whom we express our thanks for the work which he has done on this, has already pointed out that basically everything could have been somewhat more advanced had it not been for the inactivity on the part of the CEN, which has been very dilatory in drawing up and adapting the directive.	Le rapporteur, M. Koch, que nous remercions pour le travail qu'il a accompli, a signalé que, dans le fond, tout ceci pourrait déjà être un peu plus avancé sans la négligence du CEN, qui a énormément tardé à élaborer et à harmoniser la directive.
That is why we can only hope - and we should resolve all of this this week - that, in 2001, we will finally have Community regulations for the transport of dangerous goods by road so that we have a degree of legal certainty here and also so that our roads are a good deal safer.	Nous ne pouvons donc qu'espérer - et nous devrions prendre toutes les décisions à cet effet au cours de cette semaine - qu'en 2001, nous disposions enfin de réglementations communautaires pour le transport de marchandises dangereuses par route afin d'avancer en matière de sécurité juridique et aussi de sécurité sur nos routes.
Mr President, the report we are discussing here does not, in itself, entail any major changes.	Monsieur le Président, le rapport auquel nous avons à faire n' implique pas, en soi, de grands changements.
Most of the proposed amendments are of a purely technical nature.	La plupart des propositions d' amendement sont de nature purement technique.
It is nonetheless worth emphasising that, each time we make this type of decision, it is good from a broad environmental perspective and it is beneficial because it creates better prior conditions for exploiting the possibilities of the internal market.	Néanmoins, il vaut la peine de souligner que chaque fois que nous prenons une décision de ce type, c' est une bonne chose du point de vue de l' environnement, en l' occurrence parce que cette disposition créera de meilleures conditions pour le fonctionnement du marché intérieur.
Very large quantities of dangerous goods are transported around the EU, both on roads and railways and by sea.	De grandes quantités de marchandises dangereuses sont transportées via les routes, le réseau ferroviaire et les ports de l' Union européenne.
This makes it necessary to have proper rules governing transport of this kind.	Il est donc nécessaire d'adopter des réglementations adéquates pour régir ces transports.
In area after area, we are now obtaining common minimum regulations for the Member States.	Nous obtenons progressivement, secteur après secteur, que les États membres appliquent des règles minimales communes.
This is extraordinarily positive, and there is cause to thank the rapporteur, Mr Koch, for the work he has put in on this issue.	C' est une évolution tout à fait positive, et nous avons tout lieu de remercier le rapporteur, M. Koch, pour le travail qu' il a réalisé sur ce sujet.
This is also important where the prerequisites for the internal market are concerned.	C' est également une question importante au regard des conditions de fonctionnement du marché intérieur.
If we are to get a common transport market genuinely up and running, it is important that we should not only have regulations but that these regulations should also, as far as possible, apply to every country.	Si nous voulons faire en sorte que fonctionne réellement le marché commun des transports à l' échelle de l' Union, il est important non seulement que des règles existent, mais que, dans toute la mesure du possible, ces règles nous soient communes.
I should like to conclude by commenting on a third matter which is also of significance, namely an amendment tabled by Member of Parliament, Mr Ari Vatanen.	Enfin, je voudrais commenter un troisième point qui me paraît également essentiel, à savoir une proposition d' amendement qui a été déposée par M. Ari Vatanen.
In many ways, the prerequisites differ from one Member State to another.	Le contexte que connaissent nos différents États membres est, à bien des égards, divers.
By approving this amendment, we take account of the fact that it can be very cold in the northern parts of the European Union.	Cette proposition d' amendement a pour but que l' on tienne compte des grands froids que peuvent connaître les régions septentrionales de l' Union.
This makes it necessary to also take account of the ways in which materials and packaging are affected by cold of this kind.	C' est une circonstance particulière qui exige que l' on prenne aussi en considération l' effet que peuvent avoir ces températures très basses sur les marchandises et leurs emballages.
It is good that, in establishing the present regulations, we can also be flexible.	Monsieur le Président, le fait d' imprimer une certaine souplesse à cette réglementation est positif.
I hope that the Commission is able to accept the present amendment.	J' espère que la Commission acceptera cet amendement.
Mr President, I would like to thank not only Mr Koch, but also the Vice-President of the Commission for the clear and unambiguous way in which they have declared their support for safety in the transport sector and acknowledged it as a priority.	Monsieur le Président, je voudrais remercier non seulement M. Koch mais aussi la vice-présidente de la Commission pour s'être engagée aussi clairement en faveur de la sécurité dans le domaine des transports et avoir reconnu le caractère prioritaire de celle-ci.
The reason Mr Koch produced his sound report was because the work in the CEN and within the United Nations Economic Commission was proceeding none too expeditiously.	Si M. Koch a rédigé son bon rapport, c'est parce que le travail n'a pas été exécuté de manière trop rapide au sein du CEN et de la commission économique des Nations unies.
I would like to ask the Vice-President if she is in a position to tell us today what the state of play is with regard to the efforts towards harmonisation being made by these two organisations, and whether the EU is in a position to hasten these harmonisation efforts, in accordance with principles that are as simple as possible.	Je voudrais demander à la vice-présidente si elle peut nous dire où en sont les efforts d'harmonisation déployés par ces deux organisations et si l'UE a la possibilité d'accélérer ces efforts en appliquant des principes aussi simples que possibles.
For one thing is clear: even if we come to an excellent arrangement within the European Union, traffic does not stop at our borders, it goes beyond them.	Car une chose est claire : même si nous adoptons une excellente réglementation au sein de l'Union européenne, le trafic ne s'arrête pas à ces frontières ; il les traverse.
Hence there is certainly every reason to introduce more far-reaching regional provisions.	C'est pourquoi des réglementations plus larges, à savoir plus larges sur le plan régional, sont certainement judicieuses.
If the Commissioner is unable to do so today then would she be prepared to inform the committee in writing of how matters stand and what stage negotiations between the CEN and the Economic Commission are at?	Si Mme la commissaire ne peut le faire aujourd'hui, serait-elle prête à communiquer par écrit à la commission la situation actuelle et l'état des négociations entre le CEN et la commission économique ?
Mr President, I would once again like to congratulate Mr Koch on his magnificent work on this other report, which in a way supplements the debate which we held in October on rail transport.	Monsieur le Président, je réitère de nouveau mes félicitations à M. Koch du travail qu'il a accompli pour cet autre rapport, qui vient compléter d'une certaine manière le débat que nous avons eu au mois d'octobre sur le transport par rail.
We all regret that the European Committee for Standardisation (CEN) has not been able, in the required time, to carry out the amendment of the provisions necessary for the required harmonisation within the European Union.	Nous regrettons tous que le Comité européen de normalisation (CEN) n'ait pas été capable de réaliser dans les délais fixés la modification des dispositions nécessaire pour parvenir à une harmonisation appropriée au sein de l'Union européenne.
This debate and the amendment of the directive currently in force allow us to incorporate differentiating elements which demonstrate the diversity of this Europe of ours.	Ce débat et la modification de la directive actuellement en vigueur nous permettent d'introduire des faits différentiels qui témoignent de la diversité de notre Europe.
A moment ago, Mr Vatanen spoke to us of lower temperatures, not of 20 degrees below zero, but of 40 degrees below zero.	Il y a quelques instants, M. Vatanen nous parlait de températures inférieures, non plus à -20 degrés, mais à -40 degrés.
Of course, we accept that amendment - it is absolutely right - and I believe that we should incorporate specific circumstances which demonstrate the climatic diversity of the European Union, which sometimes take the form of specifics and of concrete requirements for the establishment of standards and characterisations of a technical nature.	Nous acceptons bien évidemment cet amendement, qui est tout à fait justifié, et je pense qu'il faut introduire des circonstances concrètes qui témoignent de la variété climatique de l'Union européenne, qui se traduit parfois en spécificités et en exigences concrètes au moment où il s'agit d'envisager des normalisations ou caractérisations de type technique.
I would like to say, with regard to Mr Swoboda' s comments on the activity of the CEN, that we are urging them to speed up their work as much as possible because it would be terrible if, despite the new deadline, we were to find ourselves after a year and a bit with the same difficulties because their work has not been concluded.	Par rapport à ce qu'a déclaré M. Swoboda au sujet de l'activité du CEN, je voudrais dire que nous insistons auprès d'eux pour qu'ils accélèrent au maximum leur travail car ce serait dramatique que, malgré le nouveau délai, nous nous retrouvions dans un peu plus d'un an devant les mêmes difficultés pour avoir été incapables d'y apporter une solution.
Lastly, Mr President, the basic problems justifying this amendment of the directive have been pointed out. We have referred to the delay by the CEN, the amendment of certain provisions, the consistency between the text of the directive and the content of the annexes and the need to for it to be more specific.	Pour terminer, Monsieur le Président, nous avons déjà mis en évidence les problèmes fondamentaux qui justifient cette modification de la directive, nous avons mentionné le retard du CEN, la modification de quelques dispositions, la cohérence entre le texte de la directive et le contenu des annexes, la nécessité d'apporter une plus grande précision.
The Commission accepts all of the contributions of the parliamentary committee and the rapporteur, Mr Koch, which are contained in the various amendments, specifically four.	Tous les apports de la commission parlementaire et du rapporteur, M. Koch, qui ont débouché sur différents amendements, concrètement quatre, sont repris par la Commission.
We therefore accept the four amendments which have been proposed.	Nous acceptons donc les quatre amendements qui nous ont été proposés.
The debate is closed.	Le débat est clos.
The vote will take place tomorrow at 12 p.m.	Le vote aura lieu demain à 12 heures.
Structural Funds - Cohesion Fund coordination	Coordination Fonds structurels/Fonds de cohésion
The next item is the report (A5-0108/1999) by Mrs Schroedter, on behalf of the Committee on Regional Policy, Transport and Tourism, on the communication from the Commission in the field of the Structural Funds and their coordination with the Cohesion Fund: guidelines for programmes in the period 2000-2006 [COM(1999)344 - C5-0122/1999 - 1999/2127(COS)].	L'ordre du jour appelle le rapport (A5-0108/1999) de Mme Schroedter, au nom de la commission de la politique régionale, des transports et du tourisme, sur la communication de la Commission "Les Fonds structurels et leur coordination avec le Fonds de cohésion. Orientations pour les programmes de la période 2000-2006" (COM(1999)344 - C5-0122/1999 - 1999/2127(COS)).
Mr President, it is particularly pleasing for me to make my first speech in the European Parliament on what is regarded as the most important issue within that part of the United Kingdom that I represent in this Parliament, namely Wales.	Monsieur le Président, je suis particulièrement ravi de ce que ma première intervention au Parlement européen porte sur ce que la région du Royaume-Uni que je représente au sein de ce Parlement, à savoir le pays de Galles, considère comme le sujet le plus important.
A major part of Wales, as you know, has been granted Objective 1 status under the Structural Funds programme.	Vous n'êtes pas sans savoir que la majeure partie du pays de Galles est devenu éligible à l'objectif 1 du programme de fonds structurels.
It is quite clear that many people within Wales are looking to the European Structural Funds programme to alleviate some of the great difficulties that we undoubtedly face.	Il est clair que nombreux sont ceux qui, au pays de Galles, voient le programme de fonds structurels comme un moyen pour enrayer certaines des grandes difficultés auxquelles nous sommes indubitablement confrontés.
We have seen poverty growing in Wales; and growing still further since 1997.	Nous avons constaté que la pauvreté va croissant au pays de Galles, tendance qui se renforce depuis 1997.
We have seen the gap between rich and poor widen.	Nous avons vu le fossé entre les riches et les pauvres se creuser.
We are looking, therefore, within the Structural Funds programme not just to see industrial restructuring but also to see a wider improvement in the whole of the economic base within the Principality.	Nous attendons donc du programme de fonds structurels qu'il ne se limite pas à envisager une restructuration industrielle, nous souhaitons qu'il apporte également de plus larges améliorations à l'ensemble de la base économique du pays de Galles.
What is, however, deeply damaging for us is the belief that in some way the granting of Structural Funds assistance is something that has been, in a sense, a success of the government. It is sadly only a recognition of the very great difficulties that Wales faces.	Ce qui nous porte cependant un grand préjudice, c'est de croire que, d'une certaine manière, l'octroi des fonds structurels a été une victoire du gouvernement, alors qu'il ne fait que reconnaître que le pays de Galles est bien confronté à de très grandes difficultés.
That is why I want to highlight some of the issues that I believe the Commission must have at the forefront.	C'est pourquoi je voudrais souligner certains points que la Commission devrait, d'après moi, placer au premier plan.
We look to the Commission to deal with points in relation to additionality.	Nous espérons que la Commission traitera des points liés à l'additionnalité.
We are dissatisfied with the fact that those figures seem to have been in some way hidden within UK figures.	Nous déplorons que, d'une certaine manière, les chiffres britanniques aient masqué les chiffres gallois.
We look to the Commission also to ensure that there is matched funding for projects.	Nous espérons également que la Commission dotera les projets des financements appropriés.
We look to it to challenge the UK Government, to ensure that the private sector, which surely must be providing the major impetus for Structural Funds expenditure, is involved in the planning stage.	Nous espérons qu'elle garantira, en allant à l'encontre du gouvernement britannique, la participation du secteur privé à la phase de planification, tant il est sûr que celui-ci doit fournir le principal élan aux dépenses des fonds structurels.
Finally, we ask that the Commission ensures that Structural Fund monies are spent in a way which is transparent.	Enfin, nous demandons à la Commissions de faire en sorte que les fonds structurels soient dépensés de manière transparente.
Too much of what takes place within this Parliament is not transparent.	Au sein de ce Parlement, la transparence fait trop souvent défaut.
This is one area in which I believe the Commission can be a very great friend to Wales.	Dans ce domaine, la Commission peut devenir la grande amie du pays de Galles.
Mr President, our committee views these issues very differently and, to start, I will speak from the point of view of research.	Monsieur le Président, notre commission traite ces questions sous bien des angles différents, et pour commencer je parlerai de l' angle de la recherche.
We see it as a very positive sign that, in her own conclusions, the rapporteur has taken account of our committee' s proposal that the Cohesion Fund countries should broaden the research infrastructure by locating universities and colleges in such a way that they would serve those who live in undeveloped regions better than now and make it easier for educated people to remain in their home districts.	Nous estimons fort positif que, dans ses conclusions, le rapporteur ait tenu compte de notre proposition selon laquelle les infrastructures de la recherche devraient être élargies dans les pays de la cohésion en implantant les écoles professionnelles et les universités de telle sorte qu' elles servent mieux les populations des régions les moins développées et qu' elles permettent aux personnes formées de demeurer dans leur région d' origine.
This will be possible with action on the part of governments, and such decentralisation of higher education will be an unquestionably useful policy in evening out development.	C' est quelque chose qu' il est possible de réaliser en prenant des mesures au niveau des pouvoirs publics. Une telle décentralisation de l' enseignement supérieur est incontestablement une politique utile quand il s' agit de garantir le développement.
Another matter we would like to address, specifically from the point of view of industrial policy, is that we would have liked the Commission to pay more attention to the effects of services, electronic commerce and the growing use of the Internet, when they were planning the coordination of Structural Funds and Cohesion Funds.	Le deuxième point sur lequel nous voulions attirer l' attention, précisément dans l' optique de la politique industrielle, c' est que nous aurions souhaité qu' en réfléchissant à la coordination des Fonds structurels et du Fonds de cohésion, la Commission attache une plus grande attention à l' incidence de la progression des services, du commerce électronique et de l' utilisation de l' Internet.
Poverty and wealth used to depend more on means of livelihood.	Autrefois, la pauvreté et la richesse étaient plus tributaires des structures de la vie économique.
The rich areas were those where there were jobs in industry, but today those areas might have become a burden, and they may well be poor, meaning we also have to invest in new sectors of industry such as electronic production, as I might call it, and the production of services, because they are the industries of the future.	Les régions riches étaient celles où il y avait des emplois industriels, alors qu' aujourd' hui ces régions peuvent très bien être devenues un fardeau et être pauvres. Il devient donc nécessaire de procéder aussi à des investissements dans les nouveaux secteurs d' activité, la production dite "électronique" et la production de services électroniques, parce que ce sont des secteurs d' avenir.
In my opinion the committee drafting the report has not taken sufficient account of this, so on behalf of the Committee on Industry, External Trade, Research and Energy, I would draw the Commission' s attention to this issue.	À mon avis, la commission chargée de l' élaboration du rapport n' a pas suffisamment pris en considération cet aspect dans son propre rapport, et c' est pourquoi, au nom de la commission de l' industrie, du commerce extérieur, de la recherche et de l' énergie, j' attire l' attention de la Commission européenne là-dessus.
Finally, as the committee representing energy, we would have liked the issue of support for renewable energy resources from Cohesion and Regional Development funds to have been emphasised still more, thus, through a process of coordination, increasing the use of renewables so that the scant funding resources in the energy programme might have been compensated by means of these more substantial sums.	Enfin, puisque notre commission s' occupe de questions énergétiques, nous aurions souhaité que l' on insiste encore davantage sur le soutien à apporter aux énergies renouvelables grâce aux ressources des Fonds structurels et du Fonds de cohésion, ce qui aurait permis, par un processus de coordination, d' augmenter l' exploitation des formes d' énergie renouvelables, de telle sorte que l' insuffisance des ressources de financement du programme Énergie aurait pu être compensée grâce à ces fonds plus conséquents.
Mr President, I would very much like to thank Mrs Schroedter for the work she has done on this and to explain to colleagues that I am speaking for my colleague, Mrs Flautre, who followed this for the Committee on Employment and Social Affairs but who is unfortunately ill.	Monsieur le Président, je souhaite vivement remercier Mme Schroedter pour le travail qu'elle a accompli dans ce domaine et expliquer aux députés que j'interviens au nom de ma collègue, Mme Flautre, qui a suivi ce sujet pour la commission de l'emploi et des affaires sociales mais qui est hélas malade.
I would like to draw people's attention to Amendments Nos 1 and 2 which were agreed by the Committee on Employment and Social Affairs but not accepted by the Committee on Regional Policy, Transport and Tourism.	Je voudrais attirer l'attention sur les amendements 1 et 2 que la commission de l'emploi et des affaires sociales a approuvés, mais que la commission de la politique régionale, des transports et du tourisme n'a pas acceptés.
These amendments deal with the social economy and the need to provide social risk capital and support financially local schemes to develop employment opportunities and strengthen social cohesion.	Ces amendements ont trait à l'économie sociale et à la nécessité de mettre en place un social risk capital et de soutenir financièrement des plans locaux de développement des potentialités en matière d'emploi et de renforcement de la cohésion sociale.
In the past, this Parliament has viewed the social economy as an important potential provider of employment.	Dans le passé, le Parlement a envisagé l'économie sociale comme un fournisseur potentiel important d'emplois.
These amendments also fit in with this Parliament's view that social exclusion is a serious issue needing constructive action.	Ces amendements vont dans le sens de l'avis du Parlement selon lequel l'exclusion sociale est un problème grave qui appelle une action constructive.
We hope that those considering rejection of these amendments have very powerful reasons to offer to both Parliament and their citizens who are seeking employment.	Nous espérons que ceux qui envisagent de voter contre ces amendements pourront donner de bonnes raisons de leur choix au Parlement et aux citoyens qui sont à la recherche d'un emploi.
In her report, Mrs Flautre also drew attention to an area where coordination is sorely lacking, yet desperately needed.	Dans son rapport, Mme Flautre souligne également un domaine où il y a un manque cruel de coordination, alors qu'on en a désespérément besoin.
The Commission proposals refer to the four pillars of employment strategy and the five fields of action of the European Social Fund.	Les propositions de la Commission se réfèrent aux quatre piliers de la stratégie d'emploi et aux cinq domaines d'actions du Fonds social européen.
But the lack of specific guidelines here is particularly to be regretted, as the idea of linking Social Fund assistance to the employment strategy will be put into effect for the first time during the 2000-2006 programme.	Mais le manque de lignes directrices est ici particulièrement regrettable, alors que l'idée de lier les interventions du Fonds social à la stratégie de l'emploi sera appliquée pour la première fois lors de la période du programme 2000-2006.
It could be said that the omission gives the impression that the Commission too has no idea how to provide maximum coordination between European Social Fund assistance, which is subject to review after three and a half years, and the Member States' annual national plans for employment.	On pourrait dire que l'oubli donne l'impression que la Commission ne sait pas non plus comment assurer un maximum de coordination entre les interventions du Fonds social européen, sujettes à une révision après 3 ans et demi, et les plans nationaux pour l'emploi annuels des États membres.
We hope that the Commission can reassure us that this was an oversight which is now being dealt with constructively.	Nous espérons que la Commission pourra nous rassurer et nous dire qu'il s'agit d'un oubli, qu'elle réparera de manière constructive.
Mr President, Commissioner, the proposal presented by the Commission, in accordance with its mandate, is a reasonable starting point for the Committee on Agriculture and Rural Development.	Monsieur le Président, Monsieur le Commissaire, Mesdames et Messieurs les Députés, la proposition présentée par la Commission, remplissant ainsi son mandat, est, de l'avis de la commission de l'agriculture et du développement rural, un point de départ raisonnable.
I would like to point out, however, that this starting point indicates to us the challenges which face us: maintaining a population in rural areas, given the changes taking place in all types of economic activity owing to agriculture' s increasing lack of importance amongst the various sources of income for rural society.	Mais je voudrais souligner ici que ce point de départ nous montre les défis devant lesquels nous nous trouvons : maintenir la population dans les zones rurales, face aux changements qui interviennent dans tous les types d'activités économiques en raison de la perte croissante de poids du secteur agricole face aux différentes sources de revenu de la société rurale.
This, as well as the deficiencies in the networks of infrastructures and services and a generally very low level of employment, which furthermore is seasonal and lacks diversity, exacerbates the exodus from rural areas.	Ceci, ajouté aux déficiences des réseaux d'infrastructures et de services et à une offre d'emploi généralement très limitée et tout au plus saisonnière et peu diversifiée, accentuent l'exode rural.
The consequences do not inspire hope.	Les conséquences ne se font pas attendre.
It is the young people who are disappearing, who are getting an education and finding work outside of the rural areas, all of which has an unfavourable effect on those areas.	Ce sont les jeunes qui disparaissent, qui acquièrent une formation et trouvent un emploi en dehors des zones rurales, ce qui a une incidence défavorable sur ces zones.
This lack of infrastructure is also an obstacle to the establishment of companies and the creation of jobs.	Cette absence d'infrastructures constitue également un obstacle à l'implantation d'entreprises et à la création d'emplois.
We have to remember that rural areas represent almost four fifths of the territory of the European Union.	Il faut tenir compte du fait que l'espace rural représente presque quatre cinquièmes du territoire de l'Union européenne.
Agriculture only provides 5.5% of employment in the Union.	L'agriculture fournit seulement 5,5 % de l'emploi de l'Union.
Furthermore, three quarters of our farm workers are part-time and require supplements to their incomes.	De plus, les trois quarts de nos agriculteurs le sont à temps partiel et ont besoin de revenus d'appoint efficaces.
For this reason, one of the most important and essential objectives which we should set in the European Union is to make efforts to create new jobs in rural areas, outside of the agricultural sector, in sectors such as rural tourism, sport, culture, heritage conservation, the conversion of businesses, new technologies, services, etc. However, even though the role of agriculture is not exclusive, it is still essential, not only to prevent economic and social disintegration and the creation of ghost towns, but also because farmers play a fundamental role in managing the land, in preserving biodiversity and in protecting the environment.	C'est la raison pour laquelle un des objectifs les plus importants et transcendants que nous devrions nous fixer dans l'Union européenne serait de centrer nos efforts sur la création de nouveaux postes de travail dans les zones rurales, en dehors du secteur agricole, dans des secteurs tels que le tourisme rural, le sport, la culture, la restauration du patrimoine, l'implantation, la reconversion des entreprises, les nouvelles technologies, les services, etc. Cependant, s'il est vrai que le rôle de l'agriculture n'est pas exclusif, il reste essentiel non seulement si l'on veut éviter la désintégration économique et sociale des zones rurales et la création de nouvelles villes fantômes, mais également parce que les agriculteurs jouent un rôle fondamental dans la gestion du territoire, dans la préservation de la biodiversité et dans la protection de l'environnement.
Therefore, we support the establishment of an agricultural and rural development policy which is consistent with the objectives we have set. We want rural areas, at the dawn of the 21st century, to be competitive and multi-functional, both with regard to agriculture and with regard to opening up to the diversity of non-agricultural activities.	Par conséquent, nous soutenons la mise en uvre d'une politique agricole et de développement rural cohérente avec les objectifs que nous avons fixés et le fait que les zones rurales, à l'aube du XXIe siècle, doivent être compétitives et multifonctionnelles, tant dans le domaine agricole que dans l'ouverture à la diversité des activités non agricoles.
It is important to prioritise general criteria for land planning and demographic equilibrium, and to bear in mind the conclusions of the Committee on Agriculture and Rural Development on the five fundamental issues, which have been only partly taken up by the Committee on Transport, Regional Policy and Tourism in its points 16 and 17.	Il est important de définir des critères généraux d'aménagement du territoire et d'équilibre de la population et de prendre en considération les conclusions auxquelles est parvenue la commission de l'agriculture et du développement rural sur cinq aspects fondamentaux, qui n'ont été que partiellement repris par la commission de la politique régionale, des transports et du tourisme dans les points 16 et 17.
In conclusion, I would ask the Commission to take these five points into account when establishing the conclusions on the four pillars because I believe that, for the European Union, maintaining the population in rural areas must be one of the priority objectives.	En conclusion, je voudrais demander à la Commission que ces cinq points soient pris en considération au moment de l'établissement ses conclusions des quatre piliers, parce que j'estime que, pour l'Union européenne, le maintien de la population dans le milieu rural doit être un des objectifs prioritaires.
Mr President, Commissioner, I would like to begin by thanking Mrs Schroedter, the rapporteur, for her work.	Monsieur le Président, Monsieur le Commissaire, chers collègues, je voudrais commencer mon intervention en remerciant Mme Schroedter, rapporteur, du travail qu'elle a effectué.
I think that this work has been carried out extremely well.	Je pense que c'est un très bon travail.
I would also like to thank her for her willingness to enter into dialogue with the other political groups when compromise formulas have needed to be reached in the face of this avalanche of amendments - and perhaps there are more of them than we expected - but which genuinely reflect the importance of the report we are now discussing.	De plus, je voudrais la remercier pour sa volonté de dialogue avec les autres groupes politiques en vue de trouver des formules de compromis devant cette avalanche d'amendements, peut-être plus nombreux que ce à quoi on s'attendait, mais qui font réellement écho à l'importance du rapport dont nous sommes en train de parler.
We feel that it is important that the Commission takes account of the conclusions adopted by this Parliament, at least in spirit, because at this stage, it might seem as though what we are doing here is a useless exercise, and nothing but hot air.	Il est à nos yeux important que les conclusions approuvées dans ce Parlement soient prises en considération par la Commission, au moins en esprit, parce qu'au niveau où nous sommes, on pourrait avoir l'impression que nous ne faisons ici qu'un exercice inutile, purement rhétorique.
The truth of the matter though is that we believe - and this is also shown in the way the conclusions have been drafted - that the Commission must take account of what is adopted by this Parliament, particularly in the face of an interim revision of these directives.	Mais la vérité est que nous estimons, et cela se reflète dans la formulation des conclusions, que la Commission doit tenir compte de ce qui est approuvé au Parlement, essentiellement en ce qui concerne la révision de ces orientations en milieu de période.
In our amendments, we have stated the importance of the necessary synergies being produced between the Structural Funds, the Cohesion Fund and Community initiatives, so that their application should be reflected, in the best and most profitable way, by the gradual elimination of disparities between regions and by the creation of jobs which are, when all is said and done, the two central purposes of the funds we are discussing.	Dans nos amendements, nous avons souligné l'importance que nous accordons à la création de synergies nécessaires entre les fonds structurels, le Fonds de cohésion et les initiatives communautaires, de telle sorte que leur application se reflète au mieux, de la manière la plus rentable, dans l'élimination progressive des inégalités entre les régions et dans la création de postes de travail, ce qui, en définitive, correspond aux deux objectifs fondamentaux des fonds dont nous sommes en train de parler.
In order to achieve a more rapid and efficient boost for attaining these objectives, we think that those who generate employment, the real entrepreneurs and those who really guarantee new sources of employment, that is, businesspeople, must participate in this initiative.	Et pour arriver à un élan plus rapide et efficace dans la satisfaction de ces objectifs, nous pensons qu'il est nécessaire que participent à cette initiative les créateurs d'emploi, les véritables entrepreneurs et ceux qui garantissent vraiment les nouvelles sources d'emploi, à savoir les patrons.
Small and medium-sized businesses, above all, need to take part in the distribution of these funds.	Il faut surtout que les patrons des petites et moyennes entreprises prennent part à la distribution de ces fonds.
If they do not, if businesspeople feel marginalised, if entrepreneurs cannot take part, not only in managing but also in receiving these funds, we will have missed an opportunity to attain our objectives more rapidly.	Si ce n'est pas le cas, si les patrons se sentent exclus, s'ils ne peuvent participer, et je ne parle pas seulement de la gestion, mais également de la réception des fonds, nous aurons manqué une chance d'atteindre nos objectifs plus rapidement.
Also, in order to attain our objectives, to overcome the disparities between regions and to seek out sources of employment, it is crucial to give our complete support to new technologies, to transport and communications networks and to renewable energies.	Pour atteindre ceux-ci, pour parvenir à surmonter les inégalités entre les régions et chercher des sources d'emploi, il est également important de miser résolument sur les nouvelles technologies, sur les réseaux de transports et de communications et sur les énergies renouvelables.
All of this must be done - I repeat - with the participation of private business, which, by uniting its efforts with those of public administrations, but complementing them, never obstructing or excluding them, will lead to the creation of wealth in society and of jobs.	Tout ceci ­ j'insiste ­ avec la participation de l'entreprise privée qui, en unissant ses efforts à ceux des administrations publiques, en les complétant, sans qu'il y ait aucune obstruction ou exclusion, est celle qui créera des richesses sociales et des postes de travail.
Mr President, it is incumbent upon me to remind my colleague, Mr Evans, of why Wales actually achieved Objective 1 status.	Monsieur le Président, il m'incombe de rappeler à mon collègue, M. Evans, la cause de l'éligibilité du pays de Galles à l'objectif 1.
It was because of the discredited policies of his own Conservative Party.	C'est le résultat des politiques discréditées de son parti, le parti conservateur.
Let me also remind him that when his party leader, Mr Hague, was Secretary of State for Wales, he broke every rule in the book on additionality which led to a stern letter from Commissioner Wulf-Mathies regarding regulatory requirements.	Permettez-moi de rappeler également que lorsque son chef de parti, M. Hague, était ministre pour le pays de Galles, il n'a respecté aucune règle du principe d'additionnalité, ce qui avait lui avait valu une lettre sévère du commissaire Wulf-Mathies concernant les obligations réglementaires.
I can tell you that the British Government is aware of its regulatory requirements on Objective 1 additionality.	Je puis vous assurer que le gouvernement britannique connaît ses obligations réglementaires quant à l'additionnalité de l'objectif 1.
I suggest Mr Evans goes back and reads the regulation.	Je suggère à M. Evans d'aller relire le règlement.
My Group has made extensive amendments to both reports up for debate today.	Mon groupe a proposé d'importants amendements aux deux rapports que nous examinons aujourd'hui.
I want to focus our minds on the essential role of the guidelines.	Je souhaiterais attirer notre attention sur le rôle essentiel des lignes directrices.
The objective is to provide a framework and tool to support and enhance economic regeneration, to get the most effective use of resources in the widest partnership and to put these regions back on the road to recovery and sustainable development so that eventually they come off the regional life-support machine.	Le but est de fournir un cadre et un outil en vue de soutenir et de stimuler la régénération économique, d'obtenir la meilleure utilisation des ressources et ce, dans le cadre du plus large partenariat possible, et de réengager ces régions sur la voie du redressement et du développement durable afin qu'elles puissent finalement débrancher le respirateur artificiel régional.
It is important to identify the skills and potential of our regions in the hi-tech sector.	Il est important d'identifier les capacités et potentialités de nos régions dans le secteur de la haute technologie.
It is particularly important in the light of reports in the media that Europe is rapidly losing ground to the US in the hi-tech growth industries of the future.	En effet, les reportages des médias montrent particulièrement que l'Europe perd rapidement du terrain vis-à-vis des États-Unis dans les industries de la haute technologie de l'avenir, en pleine croissance.
The operation of the previous round of programmes is also very instructive in telling us what guidelines should not be about.	La réalisation des programmes précédents est également très instructive. Elle nous permet de déterminer en quoi les lignes directrices ne devraient pas consister.
They should not be about creating additional layers of bureaucracy and red tape.	Elles devraient éviter de créer des couches supplémentaires de bureaucratie et de paperasserie.
They should not be about shifting priorities and policies halfway through project development, resulting in inevitable delays and underspends, particularly in the light of the new budgetary requirement.	Elles devraient éviter le changement à mi-parcours des priorités et politiques du développement du projet, car celui-ci mène inévitablement à des retards et à une dépense seulement partielle des crédits disponibles, en particulier à la lumière des nouvelles exigences budgétaires.
The implementation and operation of the guidelines cannot be left to the personal interpretation of one or other desk officer, either in the Commission or in the civil service.	La mise en uvre et le fonctionnement des lignes directrices ne peut être laissée à l'interprétation personnelle d'un fonctionnaire ou l'autre de la Commission ou de la fonction publique.
There must be an internal coherence in the Commission directorate, while respecting the specific local and regional aspects of Commission programmes.	Il doit y avoir une cohérence interne dans la direction de la Commission, dans le respect des spécificités locales et des aspects régionaux des programmes de la Commission.
The conclusion is that we must make the case for guidelines to be broad, indicative and flexible to assist our programme managers and fund-users and to get the maximum potential out of our new fields of regeneration.	Pour conclure, je dirai que nous devons faire en sorte que les lignes directrices soient larges, indicatives et souples, afin d'aider nos gestionnaires de programmes et les utilisateurs des crédits et de valoriser au mieux les potentialités de nos nouveaux domaines de régénération.
If we can inject a spirit of entrepreneurial activity into our poor and structurally weak regions we will eventually get them back onto the road of attracting substantial investor confidence, which will be the key to future success.	Si nous parvenons à introduire l'esprit d'entreprise dans nos régions pauvres et structurellement faibles, elles regagneront la confiance des importants investisseurs, clé du succès à venir.
This is how we are going to judge the success of these guidelines: whether EU regional policy with a good, solid, enabling guideline, can open up new opportunities and allow our poor and structurally weak regions to play their full part in contributing to the growth and prosperity of the EU.	Nous considérerons que ces lignes directrices sont une réussite si la politique régionale de l'UE, par le biais de bonnes lignes directrices, solides et stimulantes, parvient à ouvrir de nouvelles perspectives et à permettre aux régions pauvres et structurellement faibles de participer pleinement à la croissance et à la prospérité de l'UE.
Mr President, Commissioner, I would like to thank Mrs Schroedter for an excellent report. She has gone into the issue in some depth and in the committee debate she took account of many of the amendments that have been tabled regarding this report.	Monsieur le Président, Monsieur le Commissaire, chers collègues, je tiens à remercier Mme Schroedter pour son excellent rapport ; elle s' est consacrée à fond à sa tâche et, lors de l' examen en commission, a tenu compte des nombreux amendements qui ont été apportés.
The rapporteur has also quite rightly stated that Parliament was not heard in time regarding the guidelines.	Le rapporteur constate également fort justement que le Parlement n' a pas été consulté en temps voulu au sujet des orientations.
We are badly behind now in this matter.	Nous sommes maintenant très en retard.
Hopefully, the stands Parliament has taken will help, however, in the mid-term appraisal of the programmes and in their practical implementation.	Espérons que les prises de position du Parlement européen seront quand même utiles dans l' évaluation à mi-parcours des programmes et dans la mise en uvre pratique.
For the time, the report grew too large when it was being debated.	Par rapport au moment où il nous arrive, ce rapport est devenu beaucoup trop vaste lors des examens successifs.
It contained details and issues that had already been raised in previous reports.	On y a intégré des questions de détail et des questions qui ont déjà été abordées dans des rapports antérieurs.
At this stage it is more important to concentrate on assessing how we can use this process to steer Union regional policy, bearing in mind that the aim is to reduce regional inequality.	Au stade où nous en sommes, il vaut mieux se consacrer à une réflexion sur la manière d' orienter la politique régionale communautaire, en gardant à l' esprit que l' objectif est la réduction des disparités régionales.
Our Group emphasises the importance of the principle of subsidiarity, the responsibility of Member States and the role of local players in drafting and implementing programmes.	Notre groupe met l' accent sur le principe de subsidiarité, sur la responsabilité des États membres et sur le rôle des acteurs locaux dans l' élaboration et la mise en uvre des programmes.
It is especially important to get SMEs involved in the planning and implementation of programmes.	Il est particulièrement important de faire participer les PME à cette élaboration et à cette mise en uvre.
Our Group also considers it important to take greater account of remote and peripheral areas and wishes to increase interaction between towns and rural areas.	Notre groupe estime également qu' il importe d' accorder une plus grande attention aux régions d' outre-mer et aux autres régions périphériques et veut que l' on augmente l' interaction entre la ville et la campagne.
We oppose the excessive control the central administration of the Union and its Member States exercises and we are calling for a reduction in the bureaucracy that has taken root in the drafting and implementation of programmes.	Nous nous opposons à l' interventionnisme de l' administration centrale de l' Union et de celle des États membres et nous demandons une réduction de la bureaucratie qui s' est incrustée dans l' élaboration et la réalisation des programmes.
Projects implemented with support from the Union have had their effect watered down all too often by slow decision making and complicated administrative processes.	L' efficacité des programmes mis en uvre avec le soutien de l' Union européenne a trop souvent dû souffrir d'une prise de décision trop lente et d' une gestion trop complexe.
Funds have often been granted for projects which have had no lasting benefit for the area concerned.	Souvent, des ressources ont été attribuées à des projets n' ayant laissé aucun profit durable à la région concernée.
Projects have to be carried out more efficiently, more flexibly and they have to be made more productive.	Il faudrait que les projets soient plus efficaces, plus souples et produisent plus de résultats.
While the report was being prepared, it was interesting to discuss the Union' s regional policy in general.	L' élaboration du rapport a été l' occasion de mener un intéressant débat sur la politique régionale communautaire en général.
For us new members, it was the first time, and this was a very interesting process.	C' était pour nous, nouveaux députés, la première fois, et c' est un processus extrêmement intéressant.
This report is very good and our Group supports it.	Ce rapport est tout à fait bon et notre groupe le soutient.
Mr President, Commissioner, as proof that this Parliament has not yet overcome its role as a consultative and subordinate institution, the excellent report by a fellow member of my Group, Elisabeth Schroedter, has not been able to reach plenary sitting because the plans for regional development for the period 2000-2006 for Objective 1 regions have been sitting in the Commission' s offices for several months.	Monsieur le Président, Monsieur le Commissaire, chers collègues, la preuve que ce Parlement n'a toujours pas dépassé la phase de l'institution consultative et subordonnée est que l'excellent rapport de ma collègue, Mme Elisabeth Schroedter, n'a pas pu parvenir en plénière parce que les plans de développement régional pour la période 2000-2006 pour les territoires de l'objectif 1 sont sur la table de la Commission depuis des mois.
Bearing this in mind, this House should, in any event, demand that, before the Community support frameworks for the period in question are approved, they be studied and submitted for debate in this Parliament, specifically in light of the guidelines that we have presented today.	Compte tenu de ce qui précède, nous devons exiger en tout cas, à partir de cette Assemblée, que les cadres communautaires d'appui pour la période en question soient étudiés et soumis au débat dans ce Parlement, avant leur adoption et à la lumière des orientations que nous présentons aujourd'hui.
This is because we think that they are particularly able to create employment in the poorest and least-developed regions and we would thus contribute to reversing the harmful trends towards inequality that exist in European society and to the move towards a fairer Europe.	Nous considérons qu'ils recèlent une capacité spéciale à créer des emplois dans les territoires les plus pauvres ou les moins développés. De cette manière, nous contribuerions à modifier les tendances négatives des inégalités existantes au sein de la société européenne et à faire progresser une Europe plus juste.
Mr President, we should not forget that the main, strategic objective of the Structural and Cohesion Funds and of their coordination is to achieve economic and social cohesion.	Monsieur le Président, nous ne devrions pas perdre de vue que l'objectif principal et stratégique des fonds structurels et de cohésion, et de leur coordination, est de parvenir à la cohésion économique et sociale.
We are obliged to participate in drafting directives and also in assessing their results.	Il est de notre devoir de participer à l'élaboration des orientations, mais également à l'évaluation des résultats.
We are obliged to do so because we are the representatives of the citizens in a Europe of Citizens and not just in a Europe of States and of Regions.	Et cela parce que nous sommes les représentants des citoyens de l'Europe des citoyens, et pas seulement d'une Europe des États et des régions.
We feel that the Funds are a necessary but insufficient condition for achieving economic and social cohesion.	Nous constatons que les fonds sont une condition nécessaire mais insuffisante pour parvenir à la cohésion économique et sociale.
We might be mistaken in using the gross domestic product per inhabitant as the sole indicator.	Si nous prenons comme seul indicateur le produit intérieur brut par habitant, nous risquons de nous tromper.
Some speakers have already mentioned unemployment and the fall in population.	Certains collègues ont déjà parlé du chômage et de la diminution de la démographie.
